ナンバーゼロ	009-1
マルス	009-1
オーディン	009-1
アヤナミ	07-GHOST
カペラ	07-GHOST
バスティン	07-GHOST
ラブラドール	07-GHOST
ミロク	07-GHOST
ラゼット	07-GHOST
ジオ	07-GHOST
百野栞	11eyes
吾妻汐音	11eyes
水奈瀬ゆか	11eyes
イラ	11eyes
黒芝かなえ	11eyes
グラ	11eyes
ぴぃちゃん	30歳の保健体育
今河駿	30歳の保健体育
和田	30歳の保健体育
安藤なつ	30歳の保健体育
くぅちゃん	30歳の保健体育
ももこ	30歳の保健体育
神崎鈴子	AKB0048
渡辺麻友	AKB0048
東雲楚方	AKB0048
横溝真琴	AKB0048
藍田織音	AKB0048
高橋みなみ	AKB0048
凪沙の父	AKB0048
南野美果子	AKB0048
智恵理の父	AKB0048
板野友美	AKB0048
鰐淵恵	AKB0048
白井瑞穂	AKB0048
護	AKB0048
園智恵理	AKB0048
秋元才加	AKB0048
柏木由紀	AKB0048
安永	AKB0048
牛山	AKB0048
大島優子	AKB0048
柳川葉月	AKB0048
カーム・クラフトマン	ALDNOAH.ZERO
バルークルス	ALDNOAH.ZERO
ラフィア	ALDNOAH.ZERO
ニーナ・クライン	ALDNOAH.ZERO
詰城祐太朗	ALDNOAH.ZERO
網文韻子	ALDNOAH.ZERO
ヤーコイム	ALDNOAH.ZERO
界塚ユキ	ALDNOAH.ZERO
オルレイン	ALDNOAH.ZERO
フェミーアン	ALDNOAH.ZERO
ハークライト	ALDNOAH.ZERO
オルガ	ALDNOAH.ZERO
祭陽希咲	ALDNOAH.ZERO
エデルリッゾ	ALDNOAH.ZERO
ダルザナ・マグバレッジ	ALDNOAH.ZERO
箕国起助	ALDNOAH.ZERO
耶賀頼蒼真	ALDNOAH.ZERO
トリルラン	ALDNOAH.ZERO
不見咲カオル	ALDNOAH.ZERO
鞠戸孝一郎	ALDNOAH.ZERO
ブラド	ALDNOAH.ZERO
ライエ・アリアーシュ	ALDNOAH.ZERO
マリルシャン	ALDNOAH.ZERO
マズゥールカ	ALDNOAH.ZERO
トーマ	AMNESIA
ケント	AMNESIA
ニール	AMNESIA
藍華・S・グランチェスタ	ARIA_The_ANIMATION
出雲暁	ARIA_The_ANIMATION
アリス・キャロル	ARIA_The_ANIMATION
あゆみ・K・ジャスミン	ARIA_The_ANIMATION
アリシア・フローレンス	ARIA_The_ANIMATION
晃・E・フェラーリ	ARIA_The_ANIMATION
アルベルト	ARIA_The_ANIMATION
アルバート・ピット	ARIA_The_ANIMATION
アガサ	ARIA_The_ANIMATION
アテナ・グローリィ	ARIA_The_ANIMATION
アトラ・モンテヴェルディ	ARIA_The_ANIMATION
綾小路宇土51世	ARIA_The_ANIMATION
高槻巌	ARMS
ジャバウォック	ARMS
高槻涼	ARMS
キース・シルバー	ARMS
キャロル	ARMS
キース・ホワイト	ARMS
巴武士	ARMS
キース・バイオレット	ARMS
ガウス・ゴール	ARMS
ヴォルフ	ARMS
キース・ブラック	ARMS
キース・レッド	ARMS
ネイ	AVENGER
藤巻	Angel_Beats!
大山	Angel_Beats!
遊佐	Angel_Beats!
五十嵐	Angel_Beats!
直井文人	Angel_Beats!
フィッシュ斉藤	Angel_Beats!
チャー	Angel_Beats!
野田	Angel_Beats!
ユイ	Angel_Beats!
謎の少年	Angel_Beats!
ひさ子	Angel_Beats!
竹山	Angel_Beats!
仲村ゆり	Angel_Beats!
音無初音	Angel_Beats!
佐藤和江	Another
金木杏子	Another
猿田昇	Another
川堀健蔵	Another
和久井大輔	Another
怜子	Another
松井亜紀	Another
三神	Another
渡辺珊	Another
中尾順太	Another
江藤悠	Another
米村茂樹	Another
藤岡未咲	Another
榊原恒一	Another
藤巻奈緒美	Another
風見智彦	Another
王子誠	Another
綾野彩	Another
民江	Another
赤沢泉美	Another
多々良恵	Another
辻井雪人	Another
中島幸子	Another
久保寺紹二	Another
望月優矢	Another
千曳辰治	Another
小椋由美	Another
柿沼小百合	Another
杉浦多佳子	Another
亮平	Another
大庭	Another
水野猛	Another
前島学	Another
今井豊	Aチャンネル
天王寺渚	Aチャンネル
佐藤幸世	Aチャンネル
鎌手多季	Aチャンネル
鬼頭紀美子	Aチャンネル
ケイ子	Aチャンネル
一井透	Aチャンネル
百木るん	Aチャンネル
アキュラス	B-伝説!_バトルビーダマン
三十郎	B-伝説!_バトルビーダマン
ブル・ボーグナイン	B-伝説!_バトルビーダマン
マリリン	B-伝説!_バトルビーダマン
ベアーズ	B-伝説!_バトルビーダマン
コーネル	B-伝説!_バトルビーダマン
ジョシュア	B-伝説!_バトルビーダマン
ハナ	B-伝説!_バトルビーダマン
スライ	B-伝説!_バトルビーダマン
ザザ	BLACK_BLOOD_BROTHERS
チャン	BLACK_BLOOD_BROTHERS
秋山真之	BLACK_BLOOD_BROTHERS
アリス・イヴ	BLACK_BLOOD_BROTHERS
マロ	BLACK_CAT
アヌビス	BLACK_CAT
ターニャ	BLACK_CAT
バオ	BLACK_LAGOON
ボリス	BLACK_LAGOON
エルヴィス	BLACK_LAGOON
ジェーン	BLACK_LAGOON
花田	BLACK_LAGOON
両角	BLACK_LAGOON
シェンホア	BLACK_LAGOON
張維新	BLACK_LAGOON
鷲峰雪緒	BLACK_LAGOON
岡崎	BLACK_LAGOON
ファビオラ・イグレシアス	BLACK_LAGOON
レヴィ	BLACK_LAGOON
景山	BLACK_LAGOON
ヴェロッキオ	BLACK_LAGOON
モレッティ	BLACK_LAGOON
真希	BLACK_LAGOON
松崎銀次	BLACK_LAGOON
サハロフ	BLACK_LAGOON
チャカ	BLACK_LAGOON
ダッチ	BLACK_LAGOON
ガルシア・フェルナンド・ラブレス	BLACK_LAGOON
ロベルタ	BLACK_LAGOON
四楓院夜一	BLEACH
石田竜弦	BLEACH
獅子河原萌笑	BLEACH
志波空鶴	BLEACH
黒崎真咲	BLEACH
浅野みづ穂	BLEACH
紬屋雨	BLEACH
毒ヶ峰リルカ	BLEACH
鵯州	BLEACH
花刈ジン太	BLEACH
市丸ギン	BLEACH
阿近	BLEACH
阿散井恋次	BLEACH
みゆき	BLEACH
志波岩鷲	BLEACH
りりん	BLEACH
茶渡泰虎	BLEACH
小川みちる	BLEACH
銀城空吾	BLEACH
東仙要	BLEACH
握菱鉄裁	BLEACH
有沢竜貴	BLEACH
沓澤ギリコ	BLEACH
オスカー・ホアキン・デ・ラ・ロサ	BLEACH
月島秀九郎	BLEACH
霞大路瑠璃千代	BLEACH
志波海燕	BLEACH
黒崎遊子	BLEACH
本匠千鶴	BLEACH
因幡影狼佐	BLEACH
志波都	BLEACH
井上昊	BLEACH
藍染惣右介	BLEACH
アルトゥロ・プラテアド	BLEACH
天貝繍助	BLEACH
石田雨竜	BLEACH
井上織姫	BLEACH
ルルゥ	BLOOD+
ソーニャ	BLOOD+
モニーク	BLOOD+
フォレスト	BLOOD+
ヤーン	BLOOD+
ロジャース	BLOOD+
カルマン	BLOOD+
宮城カイ	BLOOD+
ディスマス	BLOOD+
ディーヴァ	BLOOD+
反町	BLOOD+
赤間	BLOOD+
ソロモン・ゴールドスミス	BLOOD+
宮城リク	BLOOD+
ルイス	BLOOD+
竹田	BLOOD+
ブレッド	BLOOD+
更衣唯芳	BLOOD-C
藤村駿	BLOOD-C
網埜優花	BLOOD-C
七原文人	BLOOD-C
時真慎一郎	BLOOD-C
筒鳥香奈子	BLOOD-C
ゾラ	BLUE_DRAGON
ジーロ	BLUE_DRAGON
デスロイ	BLUE_DRAGON
エリナ	BLUE_GENDER
テッド	BLUE_GENDER
藤宮紅葉	BLUE_SEED
草薙護	BLUE_SEED
沢口小梅	BLUE_SEED
ムラクモ	BLUE_SEED
三浦亨	BPS_バトルプログラマーシラセ
秋月郁	BPS_バトルプログラマーシラセ
天野美紗緒	BPS_バトルプログラマーシラセ
柚木頼子	BPS_バトルプログラマーシラセ
弐虎	BRAVE10
筧十蔵	BRAVE10
白群	BRAVE10
望月六郎	BRAVE10
由利鎌之介	BRAVE10
服部半蔵	BRAVE10
壱丸	BRAVE10
直江兼続	BRAVE10
海野六郎	BRAVE10
桜割	BRAVE10
マリーン	BRIGADOON_まりんとメラン
浅葱モト	BRIGADOON_まりんとメラン
クストン・ブラウン	BRIGADOON_まりんとメラン
ララ	BRIGADOON_まりんとメラン
クシャトーン	BRIGADOON_まりんとメラン
マイク・ホワイト	BRIGADOON_まりんとメラン
ルル	BRIGADOON_まりんとメラン
レレ	BRIGADOON_まりんとメラン
如月萌	BRIGADOON_まりんとメラン
パイオン・シルヴァー	BRIGADOON_まりんとメラン
リリ	BRIGADOON_まりんとメラン
ポイクン	BRIGADOON_まりんとメラン
鴇田純	BRIGADOON_まりんとメラン
鴇田正	BRIGADOON_まりんとメラン
エリュン・ガーネット	BRIGADOON_まりんとメラン
真乃みどり	BRIGADOON_まりんとメラン
亜呂真	BRIGADOON_まりんとメラン
ワワ	BRIGADOON_まりんとメラン
朝日奈要	BROTHERS_CONFLICT
朝日奈右京	BROTHERS_CONFLICT
朝日奈侑介	BROTHERS_CONFLICT
朝日奈弥	BROTHERS_CONFLICT
朝日奈昴	BROTHERS_CONFLICT
朝日奈風斗	BROTHERS_CONFLICT
朝日奈雅臣	BROTHERS_CONFLICT
朝日奈梓	BROTHERS_CONFLICT
朝日奈祈織	BROTHERS_CONFLICT
朝日奈椿	BROTHERS_CONFLICT
朝日奈琉生	BROTHERS_CONFLICT
朝日奈光	BROTHERS_CONFLICT
朝日奈棗	BROTHERS_CONFLICT
ミホ	BTOOOM!
平清	BTOOOM!
宮本雅志	BTOOOM!
鷹嘴	BTOOOM!
近藤勇	BTOOOM!
吉良康介	BTOOOM!
織田信隆	BTOOOM!
中条伸人	BUS_GAMER
斉藤一雄	BUS_GAMER
柳田	BUS_GAMER
ミサエ	Bonjour♪恋味パティスリー
ケイタ	Bonjour♪恋味パティスリー
ハニー	Bugってハニー
みどり	Bugってハニー
マイ	Bugってハニー
サンタ	Bugってハニー
くろボン	Bビーダマン爆外伝
モミテボン	Bビーダマン爆外伝
ダークプリンス	Bビーダマン爆外伝
セレス	Bビーダマン爆外伝
ピンクボン	Bビーダマン爆外伝
しろボン	Bビーダマン爆外伝V
あおボン	Bビーダマン爆外伝V
ドクダンディ	Bビーダマン爆外伝V
小須田崇	B型H系
片瀬葵	B型H系
赤井	B型H系
三郷まみ	B型H系
カミングズ	CANAAN
御法川実	CANAAN
リャン・チー	CANAAN
ネネ	CANAAN
大沢マリア	CANAAN
梓夜凪砂	CLAMP学園探偵団
鷹村蘇芳	CLAMP学園探偵団
テレサ	CLAYMORE
タバサ	CLAYMORE
リグ	CLAYMORE
ガラテア	CLAYMORE
クラウディア	CLAYMORE
パメラ	CLAYMORE
ベロニカ	CLAYMORE
イースレイ	CLAYMORE
リフル	CLAYMORE
ラファエラ	CLAYMORE
フローラ	CLAYMORE
オフィーリア	CLAYMORE
デネヴ	CLAYMORE
カルラ	CLAYMORE
ロード・クロサイト	CLUSTER_EDGE
ベリル・ジャスパー	CLUSTER_EDGE
フォン・アイナ・サルファー	CLUSTER_EDGE
君塚麻織	CODE-E
九条園美	CODE-E
野村タエ子	COPPELION
黒澤遥人	COPPELION
蒲田	COPPELION
江戸川	COPPELION
武者小路	COPPELION
井伏	COPPELION
三島鬼兵	COPPELION
深作葵	COPPELION
小津詩音	COPPELION
国木田	COPPELION
小津歌音	COPPELION
鷺ノ宮藍	Canvas2_〜虹色のスケッチ〜
橘天音	Canvas2_〜虹色のスケッチ〜
目時	Charlotte
乙坂歩未	Charlotte
乙坂隼翼	Charlotte
高城丈士朗	Charlotte
西森柚咲	Charlotte
熊耳	Charlotte
友利奈緒	Charlotte
白崎イリス	Classroom☆Crisis
霧羽ナギサ	Classroom☆Crisis
霧羽ユウジ	Classroom☆Crisis
瀬良ミズキ	Classroom☆Crisis
服部花子	Classroom☆Crisis
瀬良カイト	Classroom☆Crisis
ジェイソン・リー	Classroom☆Crisis
ミラ	Cosmic_Baton_Girl_コメットさん☆
太一	Cosmic_Baton_Girl_コメットさん☆
青木	Cosmic_Baton_Girl_コメットさん☆
柊修造	Cosmic_Baton_Girl_コメットさん☆
プラネット王子	Cosmic_Baton_Girl_コメットさん☆
源ちゃん	Cosmic_Baton_Girl_コメットさん☆
三島佳祐	Cosmic_Baton_Girl_コメットさん☆
今日子先生	Cosmic_Baton_Girl_コメットさん☆
メテオ	Cosmic_Baton_Girl_コメットさん☆
ラバピョン	Cosmic_Baton_Girl_コメットさん☆
上杉萌	CØDE:BREAKER
八王子泪	CØDE:BREAKER
藤原	CØDE:BREAKER
青木武	CØDE:BREAKER
大助	CØDE:BREAKER
平家将臣	CØDE:BREAKER
前田俊也	CØDE:BREAKER
渡辺	CØDE:BREAKER
藤原寧々音	CØDE:BREAKER
桜小路桜	CØDE:BREAKER
高津あおば	CØDE:BREAKER
武田	CØDE:BREAKER
人見	CØDE:BREAKER
ウィンターズ・ソカロ	D.Gray-man
シィフ	D.Gray-man
ジョニー・ギル	D.Gray-man
クラウド・ナイン	D.Gray-man
レロ	D.Gray-man
ちょめ助	D.Gray-man
フォー	D.Gray-man
ハワード・リンク	D.Gray-man
ワイズリー	D.Gray-man
ジェリー	D.Gray-man
マルコム=C=ルベリエ	D.Gray-man
ジャスデロ	D.Gray-man
デビット	D.Gray-man
バク・チャン	D.Gray-man
マホジャ	D.Gray-man
ジョン・スミス	DARKER_THAN_BLACK_-流星の双子-
ノリオ	DARKER_THAN_BLACK_-流星の双子-
コズロフ	DARKER_THAN_BLACK_-流星の双子-
鎮目弦馬	DARKER_THAN_BLACK_-流星の双子-
ゴラン	DARKER_THAN_BLACK_-流星の双子-
エイプリル	DARKER_THAN_BLACK_-流星の双子-
ミチル	DARKER_THAN_BLACK_-流星の双子-
ジュライ	DARKER_THAN_BLACK_-流星の双子-
陳	DARKER_THAN_BLACK_-黒の契約者-
アルマ	DARKER_THAN_BLACK_-黒の契約者-
ユカ	DARKER_THAN_BLACK_-黒の契約者-
アラン	DARKER_THAN_BLACK_-黒の契約者-
斎藤雄介	DARKER_THAN_BLACK_-黒の契約者-
ユン	DARKER_THAN_BLACK_-黒の契約者-
ルイ	DARKER_THAN_BLACK_-黒の契約者-
ハヴォック	DARKER_THAN_BLACK_-黒の契約者-
ディケイド	DARKER_THAN_BLACK_-黒の契約者-
ロー	DARKER_THAN_BLACK_-黒の契約者-
音響監督	DD北斗の拳
トウ	DD北斗の拳
ダガール	DD北斗の拳
リュウケン	DD北斗の拳
サウザー	DD北斗の拳
ケンシロウ	DD北斗の拳
レイア	DD北斗の拳
レン	DD北斗の拳
ジバイセキニャン	DD北斗の拳
ジャギ	DD北斗の拳
ラオウ	DD北斗の拳
牙大王	DD北斗の拳
ユリア	DD北斗の拳
ユダ	DD北斗の拳
デビルリバース	DD北斗の拳
ジュウケイ	DD北斗の拳
石井努	DEAR_BOYS
北川千尋	DEAR_BOYS
三浦蘭丸	DEAR_BOYS
布施歩	DEAR_BOYS
メロ	DEATH_NOTE
恐田奇一郎	DEATH_NOTE
高田清美	DEATH_NOTE
アイバー	DEATH_NOTE
渋井丸拓男	DEATH_NOTE
スキア	DEATH_NOTE
奈南川零司	DEATH_NOTE
レム	DEATH_NOTE
相沢周市	DEATH_NOTE
魅上照	DEATH_NOTE
ニア	DEATH_NOTE
佐々木	DEATH_NOTE
夜神粧裕	DEATH_NOTE
弥海砂	DEATH_NOTE
ワタリ	DEATH_NOTE
ジョン・マッケンロー	DEATH_NOTE
南空ナオミ	DEATH_NOTE
憂う者	DEVIL_SURVIVOR_2_the_ANIMATION
ティコ	DEVIL_SURVIVOR_2_the_ANIMATION
シヴァ	DEVIL_SURVIVOR_2_the_ANIMATION
無神コウ	DIABOLIK_LOVERS
逆巻レイジ	DIABOLIK_LOVERS
逆巻スバル	DIABOLIK_LOVERS
逆巻ライト	DIABOLIK_LOVERS
逆巻シュウ	DIABOLIK_LOVERS
無神アズサ	DIABOLIK_LOVERS
月浪シン	DIABOLIK_LOVERS
無神ルキ	DIABOLIK_LOVERS
逆巻アヤト	DIABOLIK_LOVERS
無神ユーマ	DIABOLIK_LOVERS
逆巻カナト	DIABOLIK_LOVERS
月浪カルラ	DIABOLIK_LOVERS
子狐	DOG_DAYS
カナタ	DOG_DAYS
アンジュ	DOG_DAYS
ファリーヌ	DOG_DAYS
アデライド・グランマニエ	DOG_DAYS
イスカ・マキシマ	DOG_DAYS
シャル	DOG_DAYS
タエ	DRAMAtical_Murder
羽賀	DRAMAtical_Murder
ローディ	DTエイトロン
スアン	DTエイトロン
カイル	DTエイトロン
ドリー	DTエイトロン
エリス	DTエイトロン
アイン	DTエイトロン
フィア	DTエイトロン
メイ	DTエイトロン
クラスター	DTエイトロン
エライザ	DTエイトロン
クロノ	DTエイトロン
ジュディ	DTエイトロン
シンシア	DTエイトロン
ディアナ	DTエイトロン
ロッソ	DTエイトロン
シーナ	DTエイトロン
エドリー	DTエイトロン
ベルク	DTエイトロン
ザキ	DearS
シャッポじい	Dororonえん魔くん_メ〜ラめら
雪子姫	Dororonえん魔くん_メ〜ラめら
原田梨紅	D・N・ANGEL
エリオット	D・N・ANGEL
西村祐次	D・N・ANGEL
坪内	D・N・ANGEL
アドニス	D・N・ANGEL
アル	Ergo_Proxy
イギー	Ergo_Proxy
ティモシー	Ergo_Proxy
バークリー	Ergo_Proxy
ドロシー	Ergo_Proxy
ガタリ	Ergo_Proxy
ピノ	Ergo_Proxy
ビンセント・ロウ	Ergo_Proxy
ローグ	FAIRY_TAIL
オルガ・ナナギア	FAIRY_TAIL
レクター	FAIRY_TAIL
クルックス	FAIRY_TAIL
ミッシェル・ロブスター	FAIRY_TAIL
ネッパー	FAIRY_TAIL
ヒスイ・E・フィオーレ	FAIRY_TAIL
ホロロギウム	FAIRY_TAIL
キョウカ	FAIRY_TAIL
ルーファス・ロア	FAIRY_TAIL
クロヘビ	FAIRY_TAIL
オフィウクス	FAIRY_TAIL
ジェミニ	FAIRY_TAIL
兎兎丸	FAIRY_TAIL
カグラ・ミカヅチ	FAIRY_TAIL
アルカディオス	FAIRY_TAIL
グレイ・ソルージュ	FAIRY_TAIL
カーチャ	FAIRY_TAIL
ユキノ・アグリア	FAIRY_TAIL
ウェンディ	FAIRY_TAIL
ディスト	FAIRY_TAIL
ボーズ	FAIRY_TAIL
ブルーノート・スティンガー	FAIRY_TAIL
スコーピオン	FAIRY_TAIL
サジタリウス	FAIRY_TAIL
スティング・ユークリフ	FAIRY_TAIL
ジャックポット	FAIRY_TAIL
セイラ	FAIRY_TAIL
ラハール	FAIRY_TAIL
カミカ	FAIRY_TAIL
アンジェリカ	FAIRY_TAIL
レイジ	FAIRY_TAIL
ルーシィ・アシュレイ	FAIRY_TAIL
ワカバ	FAIRY_TAIL
シェリー・ブレンディ	FAIRY_TAIL
ジョゼ・ポーラ	FAIRY_TAIL
レビィ	FAIRY_TAIL
バイロ	FAIRY_TAIL
メルディ	FAIRY_TAIL
キース	FAIRY_TAIL
ニコ	FAIRY_TAIL
アズマ	FAIRY_TAIL
ウルティア・ミルコビッチ	FAIRY_TAIL
ボボ	FAIRY_TAIL
ミラジェーン	FAIRY_TAIL
ブレイン	FAIRY_TAIL
ミコ	FAIRY_TAIL
レン・アカツキ	FAIRY_TAIL
マルド・ギール	FAIRY_TAIL
ミリアーナ	FAIRY_TAIL
ヒビキ・レイティス	FAIRY_TAIL
テンペスター	FAIRY_TAIL
ガジル	FAIRY_TAIL
ユウカ・スズキ	FAIRY_TAIL
リオン・バスティア	FAIRY_TAIL
マール	FAIRY_TAIL
ソラノ・アグリア	FAIRY_TAIL
ナツ・ドラギオン	FAIRY_TAIL
ザンクロウ	FAIRY_TAIL
スプリガン	FAIRY_TAIL
カレン・リリカ	FAIRY_TAIL
ジェニー・リアライト	FAIRY_TAIL
サミュエル	FAIRY_TAIL
ジュビア	FAIRY_TAIL
スー	FAIRY_TAIL
リヴァイア	FAIRY_TAIL
シェリア・ブレンディ	FAIRY_TAIL
エリック	FAIRY_TAIL
ウォーレン	FAIRY_TAIL
ナルプディング	FAIRY_TAIL
チェイス	FAIRY_TAIL
エルフマン	FAIRY_TAIL
ソーヤー	FAIRY_TAIL
ミネルバ・オーランド	FAIRY_TAIL
ファウスト	FAIRY_TAIL
ジェラール・フェルナンデス	FAIRY_TAIL
ダートン	FAIRY_TAIL
フレア・コロナ	FAIRY_TAIL
イヴ・ティルム	FAIRY_TAIL
支倉孝平	FORTUNE_ARTERIAL_赤い約束
千堂伽耶	FORTUNE_ARTERIAL_赤い約束
遠坂時臣	Fate/Zero
仰木	Fate/Zero
小林	Fate/Zero
シャーレイ	Fate/Zero
シモン	Fate/Zero
雨生龍之介	Fate/Zero
間桐雁夜	Fate/Zero
久宇舞弥	Fate/Zero
間桐臓硯	Fate/Zero
グレン・マッケンジー	Fate/Zero
ナタリア・カミンスキー	Fate/Zero
間桐鶴野	Fate/Zero
ユーブスタクハイト・フォン・アインツベルン	Fate/Zero
アサ子	Fate/Zero
衛宮矩賢	Fate/Zero
遠坂凛	Fate/kaleid_liner_プリズマ☆イリヤ
藤村大河	Fate/kaleid_liner_プリズマ☆イリヤ
セイバー	Fate/kaleid_liner_プリズマ☆イリヤ
Sella	Fate/kaleid_liner_プリズマ☆イリヤ
森山那奈亀	Fate/kaleid_liner_プリズマ☆イリヤ
栗原火雀	Fate/kaleid_liner_プリズマ☆イリヤ
栗原雀花	Fate/kaleid_liner_プリズマ☆イリヤ
イオリ	Fate/kaleid_liner_プリズマ☆イリヤ
言峰綺礼	Fate/kaleid_liner_プリズマ☆イリヤ
衛宮切嗣	Fate/kaleid_liner_プリズマ☆イリヤ
嶽間沢龍子	Fate/kaleid_liner_プリズマ☆イリヤ
バーサーカー	Fate/kaleid_liner_プリズマ☆イリヤ
衛宮士郎	Fate/kaleid_liner_プリズマ☆イリヤ
桂美々	Fate/kaleid_liner_プリズマ☆イリヤ
蒔寺楓	Fate/stay_night
間桐慎二	Fate/stay_night
氷室鐘	Fate/stay_night
美綴綾子	Fate/stay_night
イリヤスフィール・フォン・アインツベルン	Fate/stay_night
ファニー	Funny_Pets
クレセント	Funny_Pets
丸岡ナオ	GA_芸術科アートデザインクラス
野崎奈三子	GA_芸術科アートデザインクラス
野田ミキ	GA_芸術科アートデザインクラス
芦原ちかこ	GA_芸術科アートデザインクラス
大道雅	GA_芸術科アートデザインクラス
山口如月	GA_芸術科アートデザインクラス
笹本	GA_芸術科アートデザインクラス
越廼淑乃	GA_芸術科アートデザインクラス
おにわとり様	GA_芸術科アートデザインクラス
魚住	GA_芸術科アートデザインクラス
三井祐子	GA_芸術科アートデザインクラス
マリアンヌ・ファン・ティエネン	GA_芸術科アートデザインクラス
吉川	GA_芸術科アートデザインクラス
宇佐美真由実	GA_芸術科アートデザインクラス
カタナ	GAD_GUARD
サユリ	GAD_GUARD
如月タクミ	GAD_GUARD
篠塚アラシ	GAD_GUARD
マルコ・アドリアーノ	GANGSTA.
ニナ	GANGSTA.
エリカ	GANGSTA.
ガストン・ブラウン	GANGSTA.
ミハイル	GANGSTA.
山田雅史	GANTZ
加藤歩	GANTZ
北条政信	GANTZ
西丈一郎	GANTZ
玄野計	GANTZ
神田みか	GANTZ
岸本恵	GANTZ
柳田明	GATE_自衛隊_彼の地にて、斯く戦えり
富田章	GATE_自衛隊_彼の地にて、斯く戦えり
倉田武雄	GATE_自衛隊_彼の地にて、斯く戦えり
シャンディー・ガフ・マレア	GATE_自衛隊_彼の地にて、斯く戦えり
ドーラ	GATE_自衛隊_彼の地にて、斯く戦えり
マミーナ	GATE_自衛隊_彼の地にて、斯く戦えり
テュカ・ルナ・マルソー	GATE_自衛隊_彼の地にて、斯く戦えり
桑原惣一郎	GATE_自衛隊_彼の地にて、斯く戦えり
デリラ	GATE_自衛隊_彼の地にて、斯く戦えり
カトー・エル・アルテスタン	GATE_自衛隊_彼の地にて、斯く戦えり
アルペジオ・エル・レレーナ	GATE_自衛隊_彼の地にて、斯く戦えり
ボーゼス・コ・パレスティー	GATE_自衛隊_彼の地にて、斯く戦えり
今津	GATE_自衛隊_彼の地にて、斯く戦えり
ジゼル	GATE_自衛隊_彼の地にて、斯く戦えり
栗林菜々美	GATE_自衛隊_彼の地にて、斯く戦えり
夏目	GATE_自衛隊_彼の地にて、斯く戦えり
ハミルトン・ウノ・ロー	GATE_自衛隊_彼の地にて、斯く戦えり
ペルシア	GATE_自衛隊_彼の地にて、斯く戦えり
ロゥリィ・マーキュリー	GATE_自衛隊_彼の地にて、斯く戦えり
望月紀子	GATE_自衛隊_彼の地にて、斯く戦えり
デュラン	GATE_自衛隊_彼の地にて、斯く戦えり
古田均	GATE_自衛隊_彼の地にて、斯く戦えり
レレイ・ラ・レレーナ	GATE_自衛隊_彼の地にて、斯く戦えり
伊丹耀司	GATE_自衛隊_彼の地にて、斯く戦えり
ミザリィ	GATE_自衛隊_彼の地にて、斯く戦えり
森田	GATE_自衛隊_彼の地にて、斯く戦えり
マルクス	GATE_自衛隊_彼の地にて、斯く戦えり
モーム	GATE_自衛隊_彼の地にて、斯く戦えり
吉良国進	GEAR戦士電童
浅野愛子	GEAR戦士電童
黒崎	GEAR戦士電童
早瀬久美	GEAR戦士電童
シゲ	GIANT_KILLING
園田	GIANT_KILLING
片山	GIANT_KILLING
板垣	GIANT_KILLING
黒田一樹	GIANT_KILLING
徳井	GIANT_KILLING
丹波聡	GIANT_KILLING
堀	GIANT_KILLING
金田	GIANT_KILLING
村越茂幸	GIANT_KILLING
杉江勇作	GIANT_KILLING
後藤恒生	GIANT_KILLING
今井	GIANT_KILLING
清川和巳	GIANT_KILLING
石神達雄	GIANT_KILLING
カルロス	GIANT_KILLING
緑川宏	GIANT_KILLING
堀田健二	GIANT_KILLING
山井	GIANT_KILLING
藤澤桂	GIANT_KILLING
永田有里	GIANT_KILLING
椿大介	GIANT_KILLING
世良恭平	GIANT_KILLING
ダルファー	GIANT_KILLING
不破	GIANT_KILLING
赤崎遼	GIANT_KILLING
坂元	GIANT_KILLING
寺内	GIANT_KILLING
井端	GIANT_KILLING
元木	GIANT_KILLING
葛城	GIANT_KILLING
達海猛	GIANT_KILLING
平泉	GIANT_KILLING
ユキナ	GIRLSブラボー
福山リサ	GIRLSブラボー
佐々木雪成	GIRLSブラボー
森	GJ部
四ノ宮京夜	GJ部
神無月環	GJ部
綺羅々・バーンシュタイン	GJ部
四ノ宮霞	GJ部
皇紫音	GJ部
ジェラルディン・バーンシュタイン	GJ部
天使恵	GJ部
天使聖羅	GJ部
天使真央	GJ部
正岡小豆	GO!GO!575
リヴァイアサン	GOSICK_-ゴシック-
セシル・ラフィット	GOSICK_-ゴシック-
アナスタシア	GOSICK_-ゴシック-
モーリス	GOSICK_-ゴシック-
コルデリア・ギャロ	GOSICK_-ゴシック-
グレゴリー	GREGORY_HORROR_SHOW
カクタスガンマン	GREGORY_HORROR_SHOW
キャサリン	GREGORY_HORROR_SHOW
ルーレット小僧	GREGORY_HORROR_SHOW
ウンババ	GREGORY_HORROR_SHOW
ネコゾンビ	GREGORY_HORROR_SHOW
ジェームス	GREGORY_HORROR_SHOW
カクタスガール	GREGORY_HORROR_SHOW
シャシャ	Get_Ride!_アムドライバー
ジュリ・ブルーム	Get_Ride!_アムドライバー
セラ・メイ	Get_Ride!_アムドライバー
ラグナ・ラウレリア	Get_Ride!_アムドライバー
ベティ	Get_Ride!_アムドライバー
ケケ	Get_Ride!_アムドライバー
ニコラ・ルブラン	Get_Ride!_アムドライバー
ジョイ・レオン	Get_Ride!_アムドライバー
ダーク・カルホール	Get_Ride!_アムドライバー
KK	Get_Ride!_アムドライバー
シーン・ピアース	Get_Ride!_アムドライバー
雨流俊樹	GetBackers-奪還屋-
風鳥院花月	GetBackers-奪還屋-
筧十兵衛	GetBackers-奪還屋-
弥勒夏彦	GetBackers-奪還屋-
叶条夜	GetBackers-奪還屋-
美堂蛮	GetBackers-奪還屋-
笑師春樹	GetBackers-奪還屋-
天野銀次	GetBackers-奪還屋-
筧朔羅	GetBackers-奪還屋-
マリーア・ノーチェス	GetBackers-奪還屋-
弥勒雪彦	GetBackers-奪還屋-
神田ようこ	Go!プリンセスプリキュア
七瀬ゆい	Go!プリンセスプリキュア
プリンセス・ホープ・ディライト・トワ	Go!プリンセスプリキュア
一条らんこ	Go!プリンセスプリキュア
伊集院キミマロ	Go!プリンセスプリキュア
春野もえ	Go!プリンセスプリキュア
海藤つかさ	Go!プリンセスプリキュア
天ノ川ステラ	Go!プリンセスプリキュア
錦戸	Go!プリンセスプリキュア
海藤ますみ	Go!プリンセスプリキュア
キュアトゥインクル	Go!プリンセスプリキュア
春野ももか	Go!プリンセスプリキュア
春野いぶき	Go!プリンセスプリキュア
キュアマーメイド	Go!プリンセスプリキュア
海藤わたる	Go!プリンセスプリキュア
ミス・シャムール	Go!プリンセスプリキュア
瀬川ひとみ	Go!プリンセスプリキュア
トワイライト	Go!プリンセスプリキュア
紅城トワ	Go!プリンセスプリキュア
八雲雪路	H2O_-FOOTPRINTS_IN_THE_SAND-
田端ゆい	H2O_-FOOTPRINTS_IN_THE_SAND-
音羽	H2O_-FOOTPRINTS_IN_THE_SAND-
弘瀬琢磨	H2O_-FOOTPRINTS_IN_THE_SAND-
八雲はまじ	H2O_-FOOTPRINTS_IN_THE_SAND-
大門大	HAND_MAID_メイ
長谷川花子	HAUNTEDじゃんくしょん
北城遥都	HAUNTEDじゃんくしょん
龍堂和御	HAUNTEDじゃんくしょん
朝比奈睦月	HAUNTEDじゃんくしょん
スタン	HEROMAN
ゴゴール	HEROMAN
サイモン・カイナ	HEROMAN
スタリオン	HEROMAN
ヴェラ・コリンズ	HEROMAN
ドクターミナミ	HEROMAN
マシュー・デントン	HEROMAN
ウイリアム・デイヴィス	HEROMAN
アイザック＝ネテロ	HUNTER×HUNTER
クラピカ	HUNTER×HUNTER
コッコ	HUNTER×HUNTER
ポックル	HUNTER×HUNTER
ツェズゲラ	HUNTER×HUNTER
プーハット	HUNTER×HUNTER
ジョネス	HUNTER×HUNTER
ノヴ	HUNTER×HUNTER
エレナ	HUNTER×HUNTER
イータ	HUNTER×HUNTER
エリザ	HUNTER×HUNTER
レイザー	HUNTER×HUNTER
カイト	HUNTER×HUNTER
スクワラ	HUNTER×HUNTER
ビノールト	HUNTER×HUNTER
サダソ	HUNTER×HUNTER
ゲンスルー	HUNTER×HUNTER
サトツ	HUNTER×HUNTER
ピヨン	HUNTER×HUNTER
ギド	HUNTER×HUNTER
イサク	HUNTER×HUNTER
カストロ	HUNTER×HUNTER
キュウ	HUNTER×HUNTER
ギンタ	HUNTER×HUNTER
ゼパイル	HUNTER×HUNTER
リスト	HUNTER×HUNTER
アスタ	HUNTER×HUNTER
クルック	HUNTER×HUNTER
バリー	HUNTER×HUNTER
評論家	HUNTER×HUNTER
アベンガネ	HUNTER×HUNTER
トンパ	HUNTER×HUNTER
ニコル	HUNTER×HUNTER
リールベルト	HUNTER×HUNTER
マルコス	HUNTER×HUNTER
レルート	HUNTER×HUNTER
ハンゾー	HUNTER×HUNTER
モタリケ	HUNTER×HUNTER
リッポー	HUNTER×HUNTER
ヴェーゼ	HUNTER×HUNTER
高木由美子	Hellsing
ピップ・ベルナドット	Hellsing
セラス・ヴィクトリア	Hellsing
インテグラル・ファルブルケ・ウィンゲーツ・ヘルシング	Hellsing
ハインケル・ウーフー	Hellsing
シュレディンガー准尉	Hellsing
ジェネシス	Hi☆sCoool!_セハガール
うらら	Hi☆sCoool!_セハガール
ジョニー	IGPX
デュー	IGPX
リズ・リカーロ	IGPX
スコール・ミューゼル	IS_〈インフィニット・ストラトス〉
セシリア・オルコット	IS_〈インフィニット・ストラトス〉
四十院神楽	IS_〈インフィニット・ストラトス〉
雪子	IS_〈インフィニット・ストラトス〉
鷹月静寐	IS_〈インフィニット・ストラトス〉
山田真耶	IS_〈インフィニット・ストラトス〉
篠ノ之束	IS_〈インフィニット・ストラトス〉
織斑一夏	IS_〈インフィニット・ストラトス〉
篠ノ之箒	IS_〈インフィニット・ストラトス〉
織斑千冬	IS_〈インフィニット・ストラトス〉
更識簪	IS_〈インフィニット・ストラトス〉
ラウラ・ボーデヴィッヒ	IS_〈インフィニット・ストラトス〉
凰鈴音	IS_〈インフィニット・ストラトス〉
タマ子	ISUCA
島津須世璃	ISUCA
ヒミコ	IZUMO_-猛き剣の閃記-
アマテラス	IZUMO_-猛き剣の閃記-
大斗剛	IZUMO_-猛き剣の閃記-
スサノオ	IZUMO_-猛き剣の閃記-
朱雀	IZUMO_-猛き剣の閃記-
フレディ・ブラウン	KAIKANフレーズ
シズカ	KAIKANフレーズ
ヒロキ	KAIKANフレーズ
桐生敦郎	KAIKANフレーズ
聡	KAIKANフレーズ
智之	KAIKANフレーズ
工藤	KAIKANフレーズ
祐子	KAIKANフレーズ
大河内咲也	KAIKANフレーズ
沙希	KAIKANフレーズ
ユミ	KAIKANフレーズ
ダイスケ	KAIKANフレーズ
藤堂雪文	KAIKANフレーズ
トライアンフ	KIDDY_GiRL-AND
ティフォン	KIDDY_GiRL-AND
ガクトエル	KIDDY_GiRL-AND
エイオウ	KIDDY_GiRL-AND
ク・フィーユ	KIDDY_GiRL-AND
イヴェール	KIDDY_GiRL-AND
エクリプス	KIDDY_GiRL-AND
シェイド	KIDDY_GiRL-AND
ディア	KIDDY_GiRL-AND
シュウ	KIDDY_GiRL-AND
ゾマ	KIDDY_GiRL-AND
バジル	KIDDY_GiRL-AND
アンオウ	KIDDY_GiRL-AND
アリサ	KIDDY_GiRL-AND
トゥイードゥルダム	KIDDY_GiRL-AND
ウォン	KURAU_Phantom_Memory
市瀬	KURAU_Phantom_Memory
ダグ	KURAU_Phantom_Memory
ドヴェルグ	Kiddy_Grade
ヴェロニカ	Kiddy_Grade
ファイルスプリッツ	Kiddy_Grade
ヴァイパー	Kiddy_Grade
トゥインクル	Kiddy_Grade
ライトニング	Kiddy_Grade
アールヴ	Kiddy_Grade
リュミエール	Kiddy_Grade
ヴァイオラ	Kiddy_Grade
イーサン	LAST_EXILE
シカーダ	LAST_EXILE
ウォーカー	LAST_EXILE
アレックス・ロウ	LAST_EXILE
ルシオラ	LAST_EXILE
ジャンカルロ	LAST_EXILE
片桐仁	LEMON_ANGEL_PROJECT
エリカ・キャンベル	LEMON_ANGEL_PROJECT
一条龍馬	LOVE_STAGE!!
相楽玲	LOVE_STAGE!!
瀬名泉水	LOVE_STAGE!!
瀬名聖夜	LOVE_STAGE!!
瀬名聖湖	LOVE_STAGE!!
ルパン三世	LUPIN_the_Third_-峰不二子という女-
ノーラ	LUPIN_the_Third_-峰不二子という女-
アイシャ	LUPIN_the_Third_-峰不二子という女-
オスカー警部補	LUPIN_the_Third_-峰不二子という女-
次元大介	LUPIN_the_Third_-峰不二子という女-
波戸イワト	M3〜ソノ黒キ鋼〜
霞ライカ	M3〜ソノ黒キ鋼〜
破先エミル	M3〜ソノ黒キ鋼〜
田崎	M3〜ソノ黒キ鋼〜
須崎	M3〜ソノ黒キ鋼〜
謎の少女	M3〜ソノ黒キ鋼〜
鷺沼アカシ	M3〜ソノ黒キ鋼〜
出羽ササメ	M3〜ソノ黒キ鋼〜
真木ミナシ	M3〜ソノ黒キ鋼〜
弓月マアム	M3〜ソノ黒キ鋼〜
SSS	MADLAX
マーガレット・バートン	MADLAX
ダニエル・オコンネル	MASTERキートン
平賀百合子	MASTERキートン
真央	MEZZO_-メゾ-
広岡	MEZZO_-メゾ-
可奈子	MEZZO_-メゾ-
ヨハン・リーベルト	MONSTER
ヴォルフガング・グリマー	MONSTER
佐々木小次郎	MUSASHI_-GUN道-
豊臣秀頼	MUSASHI_-GUN道-
夢姫	MUSASHI_-GUN道-
小早川秀秋	MUSASHI_-GUN道-
デスペラード	MUSASHI_-GUN道-
ヤシャ	MUSASHI_-GUN道-
石田三成	MUSASHI_-GUN道-
明智光秀	MUSASHI_-GUN道-
徳川秀忠	MUSASHI_-GUN道-
ウー	Master_of_Epic_The_Animation_Age
ミミ	Mnemosyne-ムネモシュネの娘たち-
グラスホッパー	Mnemosyne-ムネモシュネの娘たち-
横井	Myself_;_Yourself
陽太	Myself_;_Yourself
織部麻緒衣	Myself_;_Yourself
八代菜々香	Myself_;_Yourself
持田雛子	Myself_;_Yourself
星野あさみ	Myself_;_Yourself
若月修輔	Myself_;_Yourself
梶井	Myself_;_Yourself
ガリ	NARUTO_-ナルト-
千手柱間	NARUTO_-ナルト-
長門	NARUTO_-ナルト-
猿飛ヒルゼン	NARUTO_-ナルト-
バキ	NARUTO_-ナルト-
フウ	NARUTO_-ナルト-
千手板間	NARUTO_-ナルト-
うちはサラダ	NARUTO_-ナルト-
犬塚ツメ	NARUTO_-ナルト-
日向ヒアシ	NARUTO_-ナルト-
マイト・ダイ	NARUTO_-ナルト-
大筒木インドラ	NARUTO_-ナルト-
赤胴ヨロイ	NARUTO_-ナルト-
並足ライドウ	NARUTO_-ナルト-
パクラ	NARUTO_-ナルト-
夕日紅	NARUTO_-ナルト-
三代目風影	NARUTO_-ナルト-
ドス・キヌタ	NARUTO_-ナルト-
うちはフガク	NARUTO_-ナルト-
照美メイ	NARUTO_-ナルト-
千手扉間	NARUTO_-ナルト-
半蔵	NARUTO_-ナルト-
縄樹	NARUTO_-ナルト-
無梨甚八	NARUTO_-ナルト-
長十郎	NARUTO_-ナルト-
うちはカガミ	NARUTO_-ナルト-
蘭丸	NARUTO_-ナルト-
栗霰串丸	NARUTO_-ナルト-
山中いのいち	NARUTO_-ナルト-
奈良シカク	NARUTO_-ナルト-
大筒木カグヤ	NARUTO_-ナルト-
ミツキ	NARUTO_-ナルト-
うちはオビト	NARUTO_-ナルト-
タマキ	NARUTO_-ナルト-
カザミ	NARUTO_-ナルト-
シホ	NARUTO_-ナルト-
ワラジ	NARUTO_-ナルト-
西瓜山河豚鬼	NARUTO_-ナルト-
うずまきヒマワリ	NARUTO_-ナルト-
弥彦	NARUTO_-ナルト-
猿飛アスマ	NARUTO_-ナルト-
二位ユギト	NARUTO_-ナルト-
うちはイズナ	NARUTO_-ナルト-
うちはイズミ	NARUTO_-ナルト-
巌流	NARUTO_-ナルト-
犬塚ハナ	NARUTO_-ナルト-
大筒木アシュラ	NARUTO_-ナルト-
キン・ツチ	NARUTO_-ナルト-
トントン	NARUTO_-ナルト-
秋道チョウザ	NARUTO_-ナルト-
ザク・アブミ	NARUTO_-ナルト-
ガトー	NARUTO_-ナルト-
中吉	NARUTO_-ナルト-
薬師ノノウ	NARUTO_-ナルト-
卯月夕顔	NARUTO_-ナルト-
日向ハナビ	NARUTO_-ナルト-
うずまきクシナ	NARUTO_-ナルト-
ハン	NARUTO_-ナルト-
うちはマダラ	NARUTO_-ナルト-
山中フー	NARUTO_-ナルト-
波風ミナト	NARUTO_-ナルト-
セン	NARUTO_-ナルト-
剣ミスミ	NARUTO_-ナルト-
ジェイ	NARUTO_-ナルト-
チヨ	NARUTO_-ナルト-
油女トルネ	NARUTO_-ナルト-
はたけサクモ	NARUTO_-ナルト-
夜叉丸	NARUTO_-ナルト-
桃地再不斬	NARUTO_-ナルト-
ツナミ	NARUTO_-ナルト-
モトイ	NARUTO_-ナルト-
重吾	NARUTO_-ナルト-_SD_ロック・リーの青春フルパワー忍伝
キラービー	NARUTO_-ナルト-_SD_ロック・リーの青春フルパワー忍伝
鬼灯水月	NARUTO_-ナルト-_SD_ロック・リーの青春フルパワー忍伝
奈良シカマル	NARUTO_-ナルト-_SD_ロック・リーの青春フルパワー忍伝
日向ヒザシ	NARUTO_-ナルト-_SD_ロック・リーの青春フルパワー忍伝
我愛羅	NARUTO_-ナルト-_SD_ロック・リーの青春フルパワー忍伝
マイト・ガイ	NARUTO_-ナルト-_SD_ロック・リーの青春フルパワー忍伝
日向ネジ	NARUTO_-ナルト-_SD_ロック・リーの青春フルパワー忍伝
カツユ	NARUTO_-ナルト-_SD_ロック・リーの青春フルパワー忍伝
大蛇丸	NARUTO_-ナルト-_SD_ロック・リーの青春フルパワー忍伝
油女シノ	NARUTO_-ナルト-_SD_ロック・リーの青春フルパワー忍伝
うちはイタチ	NARUTO_-ナルト-_SD_ロック・リーの青春フルパワー忍伝
山城アオバ	NARUTO_-ナルト-_SD_ロック・リーの青春フルパワー忍伝
次郎坊	NARUTO_-ナルト-_SD_ロック・リーの青春フルパワー忍伝
テマリ	NARUTO_-ナルト-_SD_ロック・リーの青春フルパワー忍伝
テンテン	NARUTO_-ナルト-_SD_ロック・リーの青春フルパワー忍伝
はたけカカシ	NARUTO_-ナルト-_SD_ロック・リーの青春フルパワー忍伝
小南	NARUTO_-ナルト-_SD_ロック・リーの青春フルパワー忍伝
エビス	NARUTO_-ナルト-_SD_ロック・リーの青春フルパワー忍伝
デイダラ	NARUTO_-ナルト-_SD_ロック・リーの青春フルパワー忍伝
干柿鬼鮫	NARUTO_-ナルト-_SD_ロック・リーの青春フルパワー忍伝
日向ヒナタ	NARUTO_-ナルト-_SD_ロック・リーの青春フルパワー忍伝
シズネ	NARUTO_-ナルト-_SD_ロック・リーの青春フルパワー忍伝
自来也	NARUTO_-ナルト-_SD_ロック・リーの青春フルパワー忍伝
ロック・リー	NARUTO_-ナルト-_SD_ロック・リーの青春フルパワー忍伝
うみのイルカ	NARUTO_-ナルト-_SD_ロック・リーの青春フルパワー忍伝
春野サクラ	NARUTO_-ナルト-_SD_ロック・リーの青春フルパワー忍伝
犬塚キバ	NARUTO_-ナルト-_SD_ロック・リーの青春フルパワー忍伝
猿飛木ノ葉丸	NARUTO_-ナルト-_SD_ロック・リーの青春フルパワー忍伝
神月イズモ	NARUTO_-ナルト-_SD_ロック・リーの青春フルパワー忍伝
うずまきナルト	NARUTO_-ナルト-_SD_ロック・リーの青春フルパワー忍伝
ゼツ	NARUTO_-ナルト-_SD_ロック・リーの青春フルパワー忍伝
山中いの	NARUTO_-ナルト-_SD_ロック・リーの青春フルパワー忍伝
薬師カブト	NARUTO_-ナルト-_SD_ロック・リーの青春フルパワー忍伝
うちはサスケ	NARUTO_-ナルト-_SD_ロック・リーの青春フルパワー忍伝
アダム・ブレイド	NEEDLESS
七海	NEEDLESS
未央	NEEDLESS
セト	NEEDLESS
力河	NO.6
イヌカシ	NO.6
莉莉	NO.6
富良	NO.6
カーナ	NieA_7
ジョージィ	NieA_7
チャダ	NieA_7
カイン	Night_Walker_-真夜中の探偵-
小林恵	N・H・Kにようこそ!
小林友一	N・H・Kにようこそ!
テツコ	OH!スーパーミルクチャン
カンチ	OH!スーパーミルクチャン
ヘレン	OH!スーパーミルクチャン
八神ジュン	OKAWARI-BOY_スターザンS
ダース・ベーロー	OKAWARI-BOY_スターザンS
朝倉	ONE_OUTS
中根	ONE_OUTS
西岡	ONE_OUTS
ビッグママ	ONE_OUTS
沢村	ONE_OUTS
渡久地東亜	ONE_OUTS
藤田晋	ONE_OUTS
川端	ONE_OUTS
富岡	ONE_OUTS
北野	ONE_OUTS
深山	ONE_OUTS
デニス・ジョンソン	ONE_OUTS
木ノ内	ONE_OUTS
ホーリー	ONE_PIECE
ノコ	ONE_PIECE
ダガマ	ONE_PIECE
ディック	ONE_PIECE
ミリア	ONE_PIECE
マンシェリー	ONE_PIECE
シュシュ	ONE_PIECE
ラミ	ONE_PIECE
アルベル	ONE_PIECE
モンキー・D・ドラゴン	ONE_PIECE
イナズマ	ONE_PIECE
タツ	ONE_PIECE
メリー	ONE_PIECE
レイク	ONE_PIECE
マンボシ	ONE_PIECE
ウェットン	ONE_PIECE
エンポリオ・イワンコフ	ONE_PIECE
キャロライン	ONE_PIECE
リュウボシ	ONE_PIECE
デン	ONE_PIECE
ウィッカ	ONE_PIECE
ハリー	ONE_PIECE
イシリー	ONE_PIECE
カルネ	ONE_PIECE
マキノ	ONE_PIECE
パッパグ	ONE_PIECE
ヘラクレスン	ONE_PIECE
サヨ	ONE_PIECE
ケイミー	ONE_PIECE
リナ	ONE_PIECE
リル	ONE_PIECE
ノジコ	ONE_PIECE
チャオ	ONE_PIECE
キュロス	ONE_PIECE
ゼフ	ONE_PIECE
パンダマン	ONE_PIECE
アギョウ	ONE_PIECE
ピーターマン	ONE_PIECE
アフェランドラ	ONE_PIECE
モンブラン・ノーランド	ONE_PIECE
スカーレット	ONE_PIECE
ビリー	ONE_PIECE
ジャボリ・マリエーラ	OVERMANキングゲイナー
アナ・メダイユ	OVERMANキングゲイナー
ゲイン・ビジョウ	OVERMANキングゲイナー
ママドゥ・アザフ	OVERMANキングゲイナー
アダム	Oh!ファミリー
コモロくん	PAPUWA
トウキョウ	PAPUWA
忍者トットリ	PAPUWA
ドクター高松	PAPUWA
ルーザー	PAPUWA
キンタロー	PAPUWA
くり子	PAPUWA
シンタロー	PAPUWA
津軽ジョッカー	PAPUWA
武者のコージ	PAPUWA
土方トシゾー	PAPUWA
カオルちゃん	PAPUWA
チャッピー	PAPUWA
リキッド	PAPUWA
イトウくん	PAPUWA
ジャン	PAPUWA
チェ・グソン	PSYCHO-PASS
須郷徹平	PSYCHO-PASS
縢秀星	PSYCHO-PASS
酒々井水絵	PSYCHO-PASS
金原祐治	PSYCHO-PASS
禾生壌宗	PSYCHO-PASS
雛河翔	PSYCHO-PASS
六合塚弥生	PSYCHO-PASS
ニコラス・ウォン	PSYCHO-PASS
泉宮寺豊久	PSYCHO-PASS
ブン	PSYCHO-PASS
王陵璃華子	PSYCHO-PASS
藤間幸三郎	PSYCHO-PASS
雑賀譲二	PSYCHO-PASS
唐之杜志恩	PSYCHO-PASS
東金朔夜	PSYCHO-PASS
霜月美佳	PSYCHO-PASS
藤枝美緒	Phantom_〜Requiem_for_the_Phantom〜
クロウディア・マッキェネン	Phantom_〜Requiem_for_the_Phantom〜
ナンシー・幕張	R.O.D_-THE_TV-
マギー・ムイ	R.O.D_-THE_TV-
ウェンディ・イアハート	R.O.D_-THE_TV-
読子・リードマン	R.O.D_-THE_TV-
ミシェール・チャン	R.O.D_-THE_TV-
西園はるひ	R.O.D_-THE_TV-
ドレイク・アンダーソン	R.O.D_-THE_TV-
菫川ねねね	R.O.D_-THE_TV-
菱石久美	R.O.D_-THE_TV-
金	R.O.D_-THE_TV-
リー・リンホー	R.O.D_-THE_TV-
リサ	RAGNAROK_THE_ANIMATION
ヒカル	RAGNAROK_THE_ANIMATION
ホリン	RAGNAROK_THE_ANIMATION
アリス	RAGNAROK_THE_ANIMATION
五能瞳	RAIL_WARS!
桜井あおい	RAIL_WARS!
岩泉翔	RAIL_WARS!
飯田奈々	RAIL_WARS!
札沼まり	RAIL_WARS!
小海はるか	RAIL_WARS!
高山直人	RAIL_WARS!
砂原成美	RAIL_WARS!
川又	RAINBOW-二舎六房の七人-
東田	RAINBOW-二舎六房の七人-
石原	RAINBOW-二舎六房の七人-
有藤	RAINBOW-二舎六房の七人-
ジェフリー	RAINBOW-二舎六房の七人-
高田	RAINBOW-二舎六房の七人-
前田昇	RAINBOW-二舎六房の七人-
田中	RAINBOW-二舎六房の七人-
リリィ	RAINBOW-二舎六房の七人-
早川	RAINBOW-二舎六房の七人-
熊谷	RAINBOW-二舎六房の七人-
リゼ	RAVE
レイナ	RAVE
ハムリオ・ムジカ	RAVE
ルビー	RAVE
ツヨシ	RAVE
シュダ	RAVE
スレイド	RAVE
セリア	RAVE
タンチモ	RAVE
メロディア	RAVE
ルシア・レアグローブ	RAVE
ランス	RAVE
ジークハルト・シーザー	RAVE
エリー	RAVE
グリフォン加藤	RAVE
ディープスノー	RAVE
プルー	RAVE
チーノ	RAVE
ジャヴァ・レット・ダハーカ	RAVE
ONE	RAY_THE_ANIMATION
沢	RAY_THE_ANIMATION
コーイチ	RAY_THE_ANIMATION
美里	RAY_THE_ANIMATION
真美	RAY_THE_ANIMATION
春日野	RAY_THE_ANIMATION
神子元サヤカ	RD_潜脳調査室
伊東ユキノ	RD_潜脳調査室
久島永一朗	RD_潜脳調査室
蒼井ソウタ	RD_潜脳調査室
蒼井ミナモ	RD_潜脳調査室
ホロン	RD_潜脳調査室
相楽雪政	RDG_レッドデータガール
和宮さとる	RDG_レッドデータガール
リカルド	RDG_レッドデータガール
相楽深行	RDG_レッドデータガール
宗田真澄	RDG_レッドデータガール
宗田真響	RDG_レッドデータガール
渡辺あゆみ	RDG_レッドデータガール
ロバート	RED_GARDEN
ジェシカ	RED_GARDEN
メアリー	RED_GARDEN
ルーシー	RED_GARDEN
ニック	RED_GARDEN
スーザン	RED_GARDEN
キャリー	RED_GARDEN
エマ	RED_GARDEN
ケリー	RED_GARDEN
ランディ	RED_GARDEN
ポール	RED_GARDEN
ヴァネッサ	RED_GARDEN
エミリオ	RED_GARDEN
ミレーユ	RED_GARDEN
ラウル	RED_GARDEN
サム	RED_GARDEN
ルーク	RED_GARDEN
アマンダ	RED_GARDEN
JC	RED_GARDEN
クロード	RED_GARDEN
内田すずり	RIDEBACK_-ライドバック-
上村しょう子	RIDEBACK_-ライドバック-
愛理	ROBOTICS;NOTES
澤田敏行	ROBOTICS;NOTES
与四郎	ROBOTICS;NOTES
たまき	ROBOTICS;NOTES
ミーヤ・ミーヤ	RPG伝説ヘポイ
リュート	RPG伝説ヘポイ
リンダ	Rio_RainbowGate!
ヤンヤン	Rio_RainbowGate!
島田カンベエ	SAMURAI_7
林田ヘイハチ	SAMURAI_7
ホノカ	SAMURAI_7
片山ゴロベエ	SAMURAI_7
キララ	SAMURAI_7
ユキノ	SAMURAI_7
シチロージ	SAMURAI_7
岡本カツシロウ	SAMURAI_7
キクチヨ	SAMURAI_7
ヒョーゴ	SAMURAI_7
コマチ	SAMURAI_7
マサムネ	SAMURAI_7
真尋	SAMURAI_DEEPER_KYO
椎名ゆや	SAMURAI_DEEPER_KYO
壬生京四郎	SAMURAI_DEEPER_KYO
根津甚八	SAMURAI_DEEPER_KYO
猿飛佐助	SAMURAI_DEEPER_KYO
村正	SAMURAI_DEEPER_KYO
紅虎	SAMURAI_DEEPER_KYO
遊庵	SAMURAI_DEEPER_KYO
真田信幸	SAMURAI_DEEPER_KYO
真田幸村	SAMURAI_DEEPER_KYO
徳川家康	SAMURAI_DEEPER_KYO
出雲阿国	SAMURAI_DEEPER_KYO
歳子	SAMURAI_DEEPER_KYO
鬼眼の狂	SAMURAI_DEEPER_KYO
アヤカ	SDガンダムフォース
ガンダイバー	SDガンダムフォース
ジュリ	SDガンダムフォース
アニー	SDガンダムフォース
タカヒロ	SDガンダムフォース
ナナ	SDガンダムフォース
キャプテンガンダム	SDガンダムフォース
フェン	SDガンダムフォース
リリジマーナ・ミヤ・ド・ラクロア	SDガンダムフォース
セーラ	SDガンダムフォース
けい子	SDガンダムフォース
ノア	SDガンダムフォース
ガンイーグル	SDガンダムフォース
レオナルド	SDガンダムフォース
グリフォン	SDガンダムフォース
アリシア	SDガンダムフォース
プロフェッサーガーベラ	SDガンダムフォース
虚武羅丸	SDガンダムフォース
霊帝	SDガンダム三国伝_Brave_Battle_Warriors
バウ	SDガンダム三国伝_Brave_Battle_Warriors
キュベレイ	SDガンダム三国伝_Brave_Battle_Warriors
ゲルググ	SDガンダム三国伝_Brave_Battle_Warriors
牛魔王	SF西遊記スタージンガー
紅孩児	SF西遊記スタージンガー
玄奘三蔵	SF西遊記スタージンガー
沙悟浄	SF西遊記スタージンガー
茶沢信輔	SHIROBAKO
矢野エリカ	SHIROBAKO
遠藤亮介	SHIROBAKO
渡辺隼	SHIROBAKO
佐藤沙羅	SHIROBAKO
久乃木愛	SHIROBAKO
安藤つばき	SHIROBAKO
葛城剛太郎	SHIROBAKO
安原絵麻	SHIROBAKO
木下誠一	SHIROBAKO
杉江茂	SHIROBAKO
本田豊	SHIROBAKO
高梨太郎	SHIROBAKO
藤堂美沙	SHIROBAKO
小笠原綸子	SHIROBAKO
山田昌志	SHIROBAKO
今井みどり	SHIROBAKO
平岡大輔	SHIROBAKO
落合達也	SHIROBAKO
野亀武蔵	SHIROBAKO
井口祐未	SHIROBAKO
興津由佳	SHIROBAKO
瀬川美里	SHIROBAKO
坂木しずか	SHIROBAKO
モア	SHOW_BY_ROCK!!
聖川詩杏	SHOW_BY_ROCK!!
ロム	SHOW_BY_ROCK!!
チュチュ	SHOW_BY_ROCK!!
杉原哲平	SKET_DANCE
吉彦	SKET_DANCE
石井	SKET_DANCE
安形惣司郎	SKET_DANCE
武光震平	SKET_DANCE
新田	SKET_DANCE
秋奈	SKET_DANCE
毛塚	SKET_DANCE
志村新八	SKET_DANCE
結城澪呼	SKET_DANCE
内田孝昭	SKET_DANCE
杉崎綾乃	SKET_DANCE
吉村	SKET_DANCE
美咲	SKET_DANCE
テツ	SKET_DANCE
八木薫	SKET_DANCE
武光振蔵	SKET_DANCE
薮田	SKET_DANCE
藤崎茜	SKET_DANCE
坂田銀時	SKET_DANCE
藤崎瑠海	SKET_DANCE
松井	SLAM_DUNK
諸星大	SLAM_DUNK
荒木一雄	SLAM_DUNK
越野宏明	SLAM_DUNK
田岡茂一	SLAM_DUNK
Dr.T	SLAM_DUNK
伊藤卓	SLAM_DUNK
角田悟	SLAM_DUNK
流川楓	SLAM_DUNK
彩子	SLAM_DUNK
石井健太郎	SLAM_DUNK
森重寛	SLAM_DUNK
水戸洋平	SLAM_DUNK
花形透	SLAM_DUNK
相田彦一	SLAM_DUNK
徳田	SLAM_DUNK
鉄男	SLAM_DUNK
清田信長	SLAM_DUNK
桜木花道	SLAM_DUNK
福田吉兆	SLAM_DUNK
宮益義範	SLAM_DUNK
三井寿	SLAM_DUNK
安西光義	SLAM_DUNK
長谷川一志	SLAM_DUNK
堀田徳男	SLAM_DUNK
魚住純	SLAM_DUNK
中村	SLAM_DUNK
菅平	SLAM_DUNK
宮城リョータ	SLAM_DUNK
青田龍彦	SLAM_DUNK
仙道彰	SLAM_DUNK
赤木晴子	SLAM_DUNK
小池	SLAM_DUNK
御子柴	SLAM_DUNK
安田靖春	SLAM_DUNK
新治	SPEED_GRAPHER
江古田	SPEED_GRAPHER
神田	SPEED_GRAPHER
椎名	SPEED_GRAPHER
ボブ	SPEED_GRAPHER
西谷	SPEED_GRAPHER
銀座ひばり	SPEED_GRAPHER
真壁	SPEED_GRAPHER
水天宮寵児	SPEED_GRAPHER
ヨウ・ミズノ	STAR_DRIVER_輝きのタクト
ソラ	STAR_DRIVER_輝きのタクト
イヴローニュ	STAR_DRIVER_輝きのタクト
マンティコール	STAR_DRIVER_輝きのタクト
スガタメ・タイガー	STAR_DRIVER_輝きのタクト
エンドウ・サリナ	STAR_DRIVER_輝きのタクト
シンドウ・スガタ	STAR_DRIVER_輝きのタクト
アゲマキ・ワコ	STAR_DRIVER_輝きのタクト
スカーレットキス	STAR_DRIVER_輝きのタクト
シモーヌ・アラゴン	STAR_DRIVER_輝きのタクト
ツナシ・タクト	STAR_DRIVER_輝きのタクト
ダイ・タカシ	STAR_DRIVER_輝きのタクト
カタシロ・リョウスケ	STAR_DRIVER_輝きのタクト
タクミ・タケオ	STAR_DRIVER_輝きのタクト
プロフェッサー・グリーン	STAR_DRIVER_輝きのタクト
ホンダ・ジョージ	STAR_DRIVER_輝きのタクト
ジュディ・レイエス	STEINS;GATE
黒木	STEINS;GATE
漆原るか	STEINS;GATE
比屋定真帆	STEINS;GATE
井崎	STEINS;GATE
天王寺綯	STEINS;GATE
沖五郎	SUBMARINE_SUPER_99
リチャード	Saint_October
クルツ	Saint_October
ヨシュア	Saint_October
カフカ	Saint_October
アッシュ	Saint_October
ニケ	Saint_October
セシル	Saint_October
ウィル	SoltyRei
ジョセフ	SoltyRei
ロイ・レヴァント	SoltyRei
ケリー・ジョーンズ	SoltyRei
アンディ・アンダーソン	SoltyRei
真聡	Soul_Link
水嶋有李	Starry☆Sky
高梨あい	Starry☆Sky
陽日直獅	Starry☆Sky
木ノ瀬梓	Starry☆Sky
梨本拓矢	Starry☆Sky
星月琥太郎	Starry☆Sky
不知火一樹	Starry☆Sky
青空颯斗	Starry☆Sky
白銀桜士郎	Starry☆Sky
宮地龍之介	Starry☆Sky
天羽翼	Starry☆Sky
夜久月子	Starry☆Sky
東月錫也	Starry☆Sky
水嶋郁	Starry☆Sky
金久保環	Starry☆Sky
青空空翔	Starry☆Sky
七海哉太	Starry☆Sky
神楽坂四季	Starry☆Sky
金久保誉	Starry☆Sky
桃華	Super_Seisyun_Brothers_-超青春姉弟s-
新本チコ	Super_Seisyun_Brothers_-超青春姉弟s-
斉藤マオ	Super_Seisyun_Brothers_-超青春姉弟s-
斉藤マコ	Super_Seisyun_Brothers_-超青春姉弟s-
丸岡イオリ	Super_Seisyun_Brothers_-超青春姉弟s-
山本芽	S・A
滝島彗	S・A
雑賀八尋	S・A
華園光	S・A
狩野宙	S・A
宮本誠	TARI_TARI
田中大智	TARI_TARI
宮本来夏	TARI_TARI
水野葉子	TARI_TARI
長岡	TARI_TARI
高橋智子	TARI_TARI
有田松子	TARI_TARI
川井	TARI_TARI
坂井まひる	TARI_TARI
沖田紗羽	TARI_TARI
小山内	TARI_TARI
櫟士	TEXHNOLYZE
遠山治彦	TEXHNOLYZE
シンジ	TEXHNOLYZE
吉井一穂	TEXHNOLYZE
ヨーコ	TEXHNOLYZE
大西京呉	TEXHNOLYZE
カーン	THE_UNLIMITED_兵部京介
ユウギリ	THE_UNLIMITED_兵部京介
アンディ・ヒノミヤ	THE_UNLIMITED_兵部京介
兵部京介	THE_UNLIMITED_兵部京介
アラン・ゲイブリエル	THE_ビッグオー
アレックス・ローズウォーター	THE_ビッグオー
ジョン	TOKYO_TRIBE2
スリーピー	TOKYO_TRIBE2
ツッチー	TOKYO_TRIBE2
堀越のり	TOKYO_TRIBE2
シロー	TOKYO_TRIBE2
キム	TOKYO_TRIBE2
櫻井明日香	The_Soul_Taker_〜魂狩〜
中原小麦	The_Soul_Taker_〜魂狩〜
橘沙也佳	The_Soul_Taker_〜魂狩〜
椎名霞	The_Soul_Taker_〜魂狩〜
秋葉恵	The_Soul_Taker_〜魂狩〜
伊達水脈	The_Soul_Taker_〜魂狩〜
聖子	The・かぼちゃワイン
朝丘夏美	The・かぼちゃワイン
まどか	The・かぼちゃワイン
モモ・ベリア・デビルーク	To_LOVEる_-とらぶる-
九条凛	To_LOVEる_-とらぶる-
大好誠	To_LOVEる_-とらぶる-
結城美柑	To_LOVEる_-とらぶる-
金色の闇	To_LOVEる_-とらぶる-
小川	To_LOVEる_-とらぶる-
セフィ・ミカエラ・デビルーク	To_LOVEる_-とらぶる-
古手川唯	To_LOVEる_-とらぶる-
猿山ケンイチ	To_LOVEる_-とらぶる-
黒咲芽亜	To_LOVEる_-とらぶる-
ザスティン	To_LOVEる_-とらぶる-
御門涼子	To_LOVEる_-とらぶる-
カーター	To_LOVEる_-とらぶる-
杉村	To_LOVEる_-とらぶる-
ギド・ルシオン・デビルーク	To_LOVEる_-とらぶる-
ナナ・アスタ・デビルーク	To_LOVEる_-とらぶる-
セリーヌ	To_LOVEる_-とらぶる-
ダークネス	To_LOVEる_-とらぶる-
中島	To_LOVEる_-とらぶる-
霧崎恭子	To_LOVEる_-とらぶる-
籾岡里紗	To_LOVEる_-とらぶる-
フィール	ToHeart
藍原瑞穂	ToHeart
長瀬祐介	ToHeart
兜甲児	UFOロボ_グレンダイザー
グレース・マリア・フリード	UFOロボ_グレンダイザー
五郎	UFO戦士ダイアポロン
ラビ	UFO戦士ダイアポロン
ミキ	UFO戦士ダイアポロン
松男	UFO戦士ダイアポロン
鳳ヴィヴィアン	UG☆アルティメットガール
UFOマン	UG☆アルティメットガール
諸星つぼみ	UG☆アルティメットガール
佐々光子	UN-GO
世良田蒔郎	UN-GO
佐々風守	UN-GO
結城新十郎	UN-GO
速水星玄	UN-GO
海勝梨江	UN-GO
倉田由子	UN-GO
矢島	UN-GO
牧田	UN-GO
海勝麟六	UN-GO
ホームズ	VAMPIRE_HOLMES
キラ	VAMPIRE_HOLMES
クリスティーナ	VAMPIRE_HOLMES
ケンタ	VENUS_PROJECT_-CLIMAX-
よし子	VENUS_PROJECT_-CLIMAX-
AI	VENUS_PROJECT_-CLIMAX-
サトル	VENUS_PROJECT_-CLIMAX-
原エリコ	VENUS_PROJECT_-CLIMAX-
ヘレン・ミラー	VIRUS_-VIRUS_BUSTER_SERGE-
リリス	Venus_Versus_Virus
名橋ルチア	Venus_Versus_Virus
京子	Venus_Versus_Virus
ガイ	Venus_Versus_Virus
ミカ	Venus_Versus_Virus
ライラ	Venus_Versus_Virus
ルカ	Venus_Versus_Virus
観月マナ	WHITE_ALBUM
藤井冬弥	WHITE_ALBUM
如月小夜子	WHITE_ALBUM
田丸	WHITE_ALBUM
木崎	WHITE_ALBUM2
松岡	WHITE_ALBUM2
水沢依緒	WHITE_ALBUM2
上原	WHITE_ALBUM2
浜田	WHITE_ALBUM2
北原春希	WHITE_ALBUM2
鈴木	WHITE_ALBUM2
佐藤	WHITE_ALBUM2
工藤美代子	WHITE_ALBUM2
冬馬かずさ	WHITE_ALBUM2
吉田	WHITE_ALBUM2
佐藤潤	WORKING!!
音尾春菜	WORKING!!
小鳥遊泉	WORKING!!
真柴陽平	WORKING!!
菊乃	WORKING!!
音尾兵吾	WORKING!!
山田葵	WORKING!!
種島ぽぷら	WORKING!!
小鳥遊梢	WORKING!!
山田桐生	WORKING!!
白藤杏子	WORKING!!
峰岸透	WORKING!!
真柴美月	WORKING!!
轟八千代	WORKING!!
松本麻耶	WORKING!!
小鳥遊なずな	WORKING!!
伊波まひる	WORKING!!
小鳥遊宗太	WORKING!!
相馬博臣	WORKING!!
小鳥遊一枝	WORKING!!
ミユ	Wake_Up,_Girls!
松田耕平	Wake_Up,_Girls!
杉本	Wake_Up,_Girls!
小早川ティナ	Wake_Up,_Girls!
ヨシノ	Wake_Up,_Girls!
カリーナ	Wake_Up,_Girls!
マユ	Wake_Up,_Girls!
黒川芹香	Wake_Up,_Girls!
吉川愛	Wake_Up,_Girls!
鈴木萌歌	Wake_Up,_Girls!
ナナミ	Wake_Up,_Girls!
アイリ	Wake_Up,_Girls!
丹下順子	Wake_Up,_Girls!
鈴木玲奈	Wake_Up,_Girls!
早坂相	Wake_Up,_Girls!
鈴木文明	Wake_Up,_Girls!
吉田和子	Wake_Up,_Girls!
磯川	Wake_Up,_Girls!
アンナ	Wake_Up,_Girls!
島田真夢	Wake_Up,_Girls!
近藤麻衣	Wake_Up,_Girls!
白木徹	Wake_Up,_Girls!
瀬名ロビン	Witch_Hunter_ROBIN
メトセラ	Witch_Hunter_ROBIN
コーション	Witch_Hunter_ROBIN
マイケル・リー	Witch_Hunter_ROBIN
桜塚星史郎	X_-エックス-
夏澄火煉	X_-エックス-
玖月牙暁	X_-エックス-
浅黄笙悟	X_-エックス-
皇北都	X_-エックス-
八頭司颯姫	X_-エックス-
丁	X_-エックス-
ダニエル	YAT安心!宇宙旅行
カナビー	YAT安心!宇宙旅行
カネア・マリーゴールド	YAT安心!宇宙旅行
ウッチー	YAT安心!宇宙旅行
エルマー	YAT安心!宇宙旅行
藤吉	YAT安心!宇宙旅行
ヤマモトカオル	YAT安心!宇宙旅行
石倉	YAWARA!
鴨田	YAWARA!
山下泰裕	YAWARA!
大田黒	YAWARA!
ジョディ・ロックウェル	YAWARA!
猪熊滋悟郎	YAWARA!
松田耕作	YAWARA!
徳永	YAWARA!
キム・ヨンスク	YAWARA!
須藤	YAWARA!
マルソー	YAWARA!
ギリンマ	Yes!プリキュア5
スコルプ	Yes!プリキュア5
キュアアクア	Yes!プリキュア5
アナコンディ	Yes!プリキュア5
モンブラン国王	Yes!プリキュア5
秋元まどか	Yes!プリキュア5
ネバタコス	Yes!プリキュア5
ガマオ	Yes!プリキュア5
春日野ミッシェル	Yes!プリキュア5
おタカさん	Yes!プリキュア5
たむらけんじ	Yes!プリキュア5
アラクネア	Yes!プリキュア5
クレープ王女	Yes!プリキュア5
メルポ	Yes!プリキュア5
森田よしみ	Yes!プリキュア5
シビレッタ	Yes!プリキュア5
夢原恵美	Yes!プリキュア5
春日野平蔵	Yes!プリキュア5
増子美香	Yes!プリキュア5
夏木和代	Yes!プリキュア5
ババロア女王	Yes!プリキュア5
ローゼット伯爵	Yes!プリキュア5
ムカーディア	Yes!プリキュア5
ドーナツ国王	Yes!プリキュア5
ノウマン	Z.O.E_Dolores,_i
ヤン	Z.O.E_Dolores,_i
リゲル	Z/X_IGNITION
ベガ	Z/X_IGNITION
倉敷世羅	Z/X_IGNITION
若本	Z/X_IGNITION
天王寺飛鳥	Z/X_IGNITION
マリス	Z/X_IGNITION
ミカエル	Z/X_IGNITION
アレキサンダー	Z/X_IGNITION
竜の巫女	Z/X_IGNITION
ガムビエル	Z/X_IGNITION
各務原あづみ	Z/X_IGNITION
黒崎神門	Z/X_IGNITION
上柚木綾瀬	Z/X_IGNITION
弓弦羽ミサキ	Z/X_IGNITION
ガブリエル	Z/X_IGNITION
ポラリス	Z/X_IGNITION
御影藍那	Z/X_IGNITION
ディータ	ZEGAPAIN_-ゼーガペイン-
美雨	ZEGAPAIN_-ゼーガペイン-
クリス・アヴニール	ZEGAPAIN_-ゼーガペイン-
マオ・ルーシェン	ZEGAPAIN_-ゼーガペイン-
アビス	ZEGAPAIN_-ゼーガペイン-
三崎紫雫乃	ZEGAPAIN_-ゼーガペイン-
シン	ZEGAPAIN_-ゼーガペイン-
イル	ZEGAPAIN_-ゼーガペイン-
ミナト	ZEGAPAIN_-ゼーガペイン-
レムレス	ZEGAPAIN_-ゼーガペイン-
アーク・アヴニール	ZEGAPAIN_-ゼーガペイン-
美炎	ZEGAPAIN_-ゼーガペイン-
朋美	ZETMAN
田中花子	ZETMAN
神崎人	ZETMAN
佐山	ZETMAN
中田一郎	ZETMAN
天城小葉	ZETMAN
天城高雅	ZETMAN
杉田	ZETMAN
吉住	ZOMBIE-LOAN
葬儀屋	ZOMBIE-LOAN
美空	ZOMBIE-LOAN
野木	ZOMBIE-LOAN
千鶴	ZOMBIE-LOAN
持田房子	gdgd妖精s
モガ	gdgd妖精s
ピンキー	gdgd妖精s
ファファ	gdgd妖精s
住之江圭太	kiss×sis
桐生三日月	kiss×sis
マーガレット	project_BLUE_地球SOS
ジェームズ	project_BLUE_地球SOS
ミルルン	selector_infected_WIXOSS
アン	selector_infected_WIXOSS
小湊ハツ	selector_infected_WIXOSS
タマ	selector_infected_WIXOSS
五十嵐留未	selector_infected_WIXOSS
紅林香月	selector_infected_WIXOSS
緑子	selector_infected_WIXOSS
小湊歩	selector_infected_WIXOSS
岩倉玲音	serial_experiments_lain
加藤樹莉	serial_experiments_lain
レイン	serial_experiments_lain
ミューミュー	serial_experiments_lain
石月こより	sola
四方茉莉	sola
森宮蒼乃	sola
神河繭子	sola
石月真名	sola
彩花	xxxHOLiC
猫娘	xxxHOLiC
雨童女	xxxHOLiC
凛	xxxHOLiC
四月一日君尋	xxxHOLiC
繭子	xxxHOLiC
美絵	xxxHOLiC
九軒ひまわり	xxxHOLiC
五月七日小羽	xxxHOLiC
守屋美紀	Φなる・あぷろーち
犬飼	Φなる・あぷろーち
ノッポさん	Φなる・あぷろーち
芽生百合佳	Φなる・あぷろーち
青嶋	ああっ女神さまっ
前園	ああっ女神さまっ
田宮	ああっ女神さまっ
樟葉楓子	あぃまぃみぃ!ストロベリー・エッグ
森小路	あぃまぃみぃ!ストロベリー・エッグ
姫島藤緒	あぃまぃみぃ!ストロベリー・エッグ
天和ひびき	あぃまぃみぃ!ストロベリー・エッグ
天谷颯太	あいうら
若月美鈴	あいうら
松野修作	あいうら
長瀬湊	あかね色に染まる坂
橘ミコト	あかね色に染まる坂
綾小路華恋	あかね色に染まる坂
長瀬準一	あかね色に染まる坂
浜野タタミ	あさりちゃん
ゴロマキ権藤	あしたのジョー
松木	あしたのジョー
ハリマオ	あしたのジョー
白木葉子	あしたのジョー
矢吹丈	あしたのジョー
力石徹	あしたのジョー
林紀子	あしたのジョー
立花ユズヒコ	あたしンち
立花みかん	あたしンち
浅田	あたしンち
倍賞美津子	あたしンち
藤野	あたしンち
小山田	あたしンち
石田ゆり	あたしンち
久保田	あたしンち
ミエ	あたしンち
しみちゃん	あたしンち
智美	あたしンち
クミ	あたしンち
理央	あたしンち
相原	あたしンち
森さん	あたしンち
エミコ	あたしンち
たっくん	あたしンち
西原京谷	あっちこっち
片瀬真宵	あっちこっち
戌井榊	あっちこっち
深山佳奈	あっちこっち
崎守咲	あっちこっち
桜川キクヱ	あっちこっち
音無伊御	あっちこっち
春野姫	あっちこっち
桐野亜美	あっちこっち
戌井みいこ	あっちこっち
御庭つみき	あっちこっち
御子神ハルカ	あにゃまる探偵_キルミンずぅ
宮部カスミ	あにゃまる探偵_キルミンずぅ
御子神リム	あにゃまる探偵_キルミンずぅ
羽鳥カノン	あにゃまる探偵_キルミンずぅ
ガールズ	あにゃまる探偵_キルミンずぅ
御子神ナギサ	あにゃまる探偵_キルミンずぅ
猪俣ケン	あにゃまる探偵_キルミンずぅ
龍童パルス	あにゃまる探偵_キルミンずぅ
霧島海人	あの夏で待ってる
りのん	あの夏で待ってる
有沢千春	あの夏で待ってる
霧島七海	あの夏で待ってる
貴月イチカ	あの夏で待ってる
石垣哲朗	あの夏で待ってる
小倉真奈美	あの夏で待ってる
阿刀田結子	あまえないでよっ!!
南部千歳	あまえないでよっ!!
上野一希	あまえないでよっ!!
為我井陽	あまえないでよっ!!
ミッチェル	あらいぐまラスカル
マイク・コンウェイ	あらいぐまラスカル
照屋栄子	いちばんうしろの大魔王
服部絢子	いちばんうしろの大魔王
紗伊阿九斗	いちばんうしろの大魔王
神山カンナ	いちばんうしろの大魔王
ころね	いちばんうしろの大魔王
大竹美智恵	いちばんうしろの大魔王
曽我けーな	いちばんうしろの大魔王
ブレイブ	いちばんうしろの大魔王
アルヌール	いちばんうしろの大魔王
紅日向	いつか天魔の黒ウサギ
鉄大兎	いつか天魔の黒ウサギ
時雨遥	いつか天魔の黒ウサギ
フェリス・エリス	いつか天魔の黒ウサギ
紅月光	いつか天魔の黒ウサギ
碧水泉	いつか天魔の黒ウサギ
ライナ・リュート	いつか天魔の黒ウサギ
天照大御神	いなり、こんこん、恋いろは。
ステファニー	いぬかみっ!
最長老	いぬかみっ!
ソクラテス	いぬかみっ!
アノン	うえきの法則
ケンタロウ	うえきの法則
ドン	うえきの法則
宗屋ヒデヨシ	うえきの法則
黒岩	うえきの法則
アレッシオ・ユリアーノ	うえきの法則
ロベルト・ハイドン	うえきの法則
鈴子・ジェラード	うえきの法則
明神太郎	うえきの法則
佐野清一郎	うえきの法則
キルノートン	うえきの法則
植木耕助	うえきの法則
カプーショ	うえきの法則
河地大吉	うさぎドロップ
日高	うさぎドロップ
みっちゃん	うさぎドロップ
二谷ゆかり	うさぎドロップ
憲一	うさぎドロップ
河村	うさぎドロップ
前田秀幸	うさぎドロップ
ハクオロ	うたわれるもの
ディー	うたわれるもの
ササンテ	うたわれるもの
ムント	うたわれるもの
カムチャタール	うたわれるもの
ベナウィ	うたわれるもの
エルルゥ	うたわれるもの
デリホウライ	うたわれるもの
ハウエンクア	うたわれるもの
ウルトリィ	うたわれるもの
カミュ	うたわれるもの
アルルゥ	うたわれるもの
リエ	うちゅう人_田中太郎
松野内ユタカ	うちゅう人_田中太郎
浅田きょう子	うちゅう人_田中太郎
堀町タカシ	うちゅう人_田中太郎
ユウジ	うちゅう人_田中太郎
マサミ	うちゅう人_田中太郎
ちゅーすり	うぽって!!
松本	うみものがたり_〜あなたがいてくれたコト〜
大島	うみものがたり_〜あなたがいてくれたコト〜
宮守夏音	うみものがたり_〜あなたがいてくれたコト〜
宮守都	うみものがたり_〜あなたがいてくれたコト〜
ワリン	うみものがたり_〜あなたがいてくれたコト〜
水乃小路飛鳥	うる星やつら
面堂終太郎	うる星やつら
真吾	うる星やつら
因幡	うる星やつら
ウパ	うる星やつら
藤波竜之介	うる星やつら
ルウ	うる星やつら
三宅しのぶ	うる星やつら
面堂了子	うる星やつら
秋山優花里	うーさーのその日暮らし
ダスウサ	うーさーのその日暮らし
アンジェラ・バルザック	うーさーのその日暮らし
ハルナ	うーさーのその日暮らし
お知らせうーさー	うーさーのその日暮らし
名前を呼んではいけないあの動物	うーさーのその日暮らし
みほ	うーさーのその日暮らし
イオナ	うーさーのその日暮らし
あじぽん	うーさーのその日暮らし
ピヨたん	えとたま
シャアたん	えとたま
キーたん	えとたま
ドラたん	えとたま
チュウたん	えとたま
メイたん	えとたま
イヌたん	えとたま
シマたん	えとたま
ウサたん	えとたま
ウマたん	えとたま
ウリたん	えとたま
天戸タケル	えとたま
伊勢田結花	えびてん_公立海老栖川高校天悶部
大森荘子	えびてん_公立海老栖川高校天悶部
金森羽片	えびてん_公立海老栖川高校天悶部
大庭蓮實	えびてん_公立海老栖川高校天悶部
廣松理圭	えびてん_公立海老栖川高校天悶部
戸田山響子	えびてん_公立海老栖川高校天悶部
葉山辰吉	えむえむっ!
砂戸太郎	えむえむっ!
安岡嘉助	お〜い!竜馬
千葉さな子	お〜い!竜馬
伊藤俊輔	お〜い!竜馬
吉村寅太郎	お〜い!竜馬
岩崎弥太郎	お〜い!竜馬
佐久間象山	お〜い!竜馬
吉田松陰	お〜い!竜馬
吉田東洋	お〜い!竜馬
トーマス・ブレーク・グラバー	お〜い!竜馬
沢村惣之丞	お〜い!竜馬
近藤長次郎	お〜い!竜馬
山内容堂	お〜い!竜馬
中岡慎太郎	お〜い!竜馬
日根野弁治	お〜い!竜馬
那須信吾	お〜い!竜馬
岡田以蔵	お〜い!竜馬
千葉重太郎	お〜い!竜馬
平助	お〜い!竜馬
中浜万次郎	お〜い!竜馬
坂本春猪	お〜い!竜馬
坂本乙女	お〜い!竜馬
坂本幸	お〜い!竜馬
千葉定吉	お〜い!竜馬
西郷吉之助	お〜い!竜馬
摘花一誠	おおかみかくし
真那香織	おおかみかくし
花井きく江	おおきく振りかぶって
宮下涼音	おおきく振りかぶって
高瀬準太	おおきく振りかぶって
阿部隆	おおきく振りかぶって
泉恵子	おおきく振りかぶって
巣山尚治	おおきく振りかぶって
阿部美佐枝	おおきく振りかぶって
宮田直正	おおきく振りかぶって
本山裕史	おおきく振りかぶって
石川哲郎	おおきく振りかぶって
鈴木葵	おおきく振りかぶって
松田佳之	おおきく振りかぶって
友井紋乃	おおきく振りかぶって
佐倉大地	おおきく振りかぶって
古沢淳	おおきく振りかぶって
鈴木涼	おおきく振りかぶって
仲沢利央	おおきく振りかぶって
梶山力	おおきく振りかぶって
三橋瑠里	おおきく振りかぶって
花井梓	おおきく振りかぶって
栄口勇人	おおきく振りかぶって
松永雅也	おおきく振りかぶって
秋丸恭平	おおきく振りかぶって
泉孝介	おおきく振りかぶって
斎藤優	おおきく振りかぶって
山ノ井圭輔	おおきく振りかぶって
織田裕行	おおきく振りかぶって
水谷文貴	おおきく振りかぶって
浜田良郎	おおきく振りかぶって
西広辰太郎	おおきく振りかぶって
阿部隆也	おおきく振りかぶって
仲沢呂佳	おおきく振りかぶって
柴有紀	おおきく振りかぶって
和田誠	おおきく振りかぶって
榛名元希	おおきく振りかぶって
篠岡千代	おおきく振りかぶって
加具山直人	おおきく振りかぶって
百枝まりあ	おおきく振りかぶって
真柴迅	おおきく振りかぶって
前川俊彦	おおきく振りかぶって
河合和己	おおきく振りかぶって
沖一利	おおきく振りかぶって
市原豊	おおきく振りかぶって
畠篤史	おおきく振りかぶって
島崎慎吾	おおきく振りかぶって
小山大樹	おおきく振りかぶって
青木毅彦	おおきく振りかぶって
志賀剛司	おおきく振りかぶって
若菜羽衣	おくさまが生徒会長!
ハハ	おしりかじり虫
橘	おじゃまんが山田くん
山田のぼる	おじゃまんが山田くん
山田みのる	おじゃまんが山田くん
森中	おじゃまんが山田くん
ジョージ・ワシントン	おじゃまんが山田くん
梅川	おじゃまんが山田くん
小野小町	おじゃる丸
川上さん	おじゃる丸
諸星	おじゃる丸
田村愛	おじゃる丸
むつこ	おじゃる丸
うすいさちよ	おじゃる丸
とみえ	おじゃる丸
オカメ姫	おじゃる丸
アツシ	おじゃる丸
さおり	おじゃる丸
明子	おじゃる丸
前田	おじゃる丸
アケミ	おじゃる丸
かなえ	おじゃる丸
坂田金太郎	おじゃる丸
ミツヨ	おじゃる丸
チビ太	おそ松くん
ニャロメ	おそ松くん
ダヨーン	おそ松くん
バカボンのパパ	おそ松くん
松野松代	おそ松くん
松野一松	おそ松くん
ケムンパス	おそ松くん
松野松造	おそ松くん
松野おそ松	おそ松くん
松野トド松	おそ松くん
バカボン	おそ松くん
トト子	おそ松くん
松野チョロ松	おそ松くん
松野十四松	おそ松くん
ジョーン	おちゃめなふたご_クレア学院物語
ハデス	おちゃめ神物語コロコロポロン
ヘラ	おちゃめ神物語コロコロポロン
ウインナーくん	おでんくん
チエコ	おでんくん
コロ	おでんくん
しらたき姫	おでんくん
ブラッキー	おでんくん
ハムスターのクルミ	おとぎストーリー_天使のしっぽ
朱雀のレイ	おとぎストーリー_天使のしっぽ
白虎のガイ	おとぎストーリー_天使のしっぽ
イヌのナナ	おとぎストーリー_天使のしっぽ
カメのアユミ	おとぎストーリー_天使のしっぽ
玄武のシン	おとぎストーリー_天使のしっぽ
ヘビのユキ	おとぎストーリー_天使のしっぽ
インコのツバサ	おとぎストーリー_天使のしっぽ
公星くるみ	おとぎストーリー_天使のしっぽ
ネコのタマミ	おとぎストーリー_天使のしっぽ
キンギョのラン	おとぎストーリー_天使のしっぽ
ウサギのミカ	おとぎストーリー_天使のしっぽ
タヌキのミドリ	おとぎストーリー_天使のしっぽ
キツネのアカネ	おとぎストーリー_天使のしっぽ
青龍のゴウ	おとぎストーリー_天使のしっぽ
カーネ	おとぎ銃士_赤ずきん
サンドリヨン	おとぎ銃士_赤ずきん
ジェド	おとぎ銃士_赤ずきん
ランダージョ	おとぎ銃士_赤ずきん
デュード	おとぎ銃士_赤ずきん
ラプンツェル	おとぎ銃士_赤ずきん
花桐丸竜	おとめ妖怪_ざくろ
総角景	おとめ妖怪_ざくろ
芳野葛利劔	おとめ妖怪_ざくろ
御苑生奈々子	おにいさまへ…
折原薫	おにいさまへ…
信夫マリ子	おにいさまへ…
朝霞れい	おにいさまへ…
ジェーン・ターナー	おねがい!サミアどん
アン・ホプキンス	おねがい!サミアどん
風見みずほ	おねがい☆ツインズ
まりえ	おねがい☆ツインズ
森野苺	おねがい☆ツインズ
縁川小石	おねがい☆ティーチャー
なっちゃん	おねがい☆ティーチャー
小暮駆	おねがい♪マイメロディ_きららっ★
夢野歌	おねがい♪マイメロディ_きららっ★
藤波	おはよう!スパンク
キャット	おはよう!スパンク
ロザンナ	おばけのホーリー
高山香織	おばけのホーリー
ロージー	おばけのホーリー
ミンミン	おばけのホーリー
マジョリーヌ	おばけのホーリー
マリアカラス	おばけのホーリー
料理人	おばけのホーリー
スティンキー	おばけのホーリー
チャンシー	おぼっちゃまくん
橘さゆり	おまかせスクラッパーズ
九崎凛子	おまもりひまり
リズリット・L・チェルシー	おまもりひまり
神宮寺くえす	おまもりひまり
ダイダラボッチ	おまもりひまり
ミオ	おもいっきり科学アドベンチャー_そーなんだ!
ユキオ	おもいっきり科学アドベンチャー_そーなんだ!
月形	おれは直角
綾乃	おれは直角
パンダイコン	おろしたてミュージカル_練馬大根ブラザーズ
友恵	おジャ魔女どれみ
和久のぞみ	おジャ魔女どれみ
森野かれん	おジャ魔女どれみ
藤原はづき	おジャ魔女どれみ
万田じゅんじ	おジャ魔女どれみ
佐藤なつみ	おジャ魔女どれみ
関	おジャ魔女どれみ
瀬川おんぷ	おジャ魔女どれみ
公敬	おジャ魔女どれみ
ふぁみ	おジャ魔女どれみ
サチコ	おジャ魔女どれみ
奥山なおみ	おジャ魔女どれみ
伊集院さちこ	おジャ魔女どれみ
ちえみ	おジャ魔女どれみ
林野まさと	おジャ魔女どれみ
矢田まさる	おジャ魔女どれみ
島倉かおり	おジャ魔女どれみ
温彦	おジャ魔女どれみ
魔女界の女王様	おジャ魔女どれみ
飛鳥ももこ	おジャ魔女どれみ
りえ	おジャ魔女どれみ
木根ひろこ	おジャ魔女どれみ
ニニ	おジャ魔女どれみ
万田ようこ	おジャ魔女どれみ
藤原明	おジャ魔女どれみ
八巻六郎	おジャ魔女どれみ
市川	おジャ魔女どれみ
ゆき先生	おジャ魔女どれみ
なつみ	おジャ魔女どれみ
小倉けんじ	おジャ魔女どれみ
工藤むつみ	おジャ魔女どれみ
マジョロクサーヌ	おジャ魔女どれみ
中山しおり	おジャ魔女どれみ
マジョリード	おジャ魔女どれみ
岡田ななこ	おジャ魔女どれみ
デラ	おジャ魔女どれみ
丸山みほ	おジャ魔女どれみ
林りょうた	おジャ魔女どれみ
伊藤こうじ	おジャ魔女どれみ
トオル	おジャ魔女どれみ
花田志乃	おジャ魔女どれみ
ジョルジュ・ベネックス	おジャ魔女どれみ
フジオ	おジャ魔女どれみ
長門かよこ	おジャ魔女どれみ
喜多川	おジャ魔女どれみ
春風ぽっぷ	おジャ魔女どれみ
順一	おジャ魔女どれみ
長谷部たけし	おジャ魔女どれみ
小泉まりな	おジャ魔女どれみ
中島正義	おジャ魔女どれみ
和田みんと	おジャ魔女どれみ
ジョエル	おジャ魔女どれみ
木村たかお	おジャ魔女どれみ
高橋真樹	おジャ魔女どれみ
橋本真司	おジャ魔女どれみ
妹尾あいこ	おジャ魔女どれみ
松下あや	おジャ魔女どれみ
マジョプリマ	おジャ魔女どれみ
佐川ゆうじ	おジャ魔女どれみ
藤原麗子	おジャ魔女どれみ
有馬健一	おジャ魔女どれみ
山本けいこ	おジャ魔女どれみ
スザンヌ	おジャ魔女どれみ
梅野ゆかり	おジャ魔女どれみ
玉木麗香	おジャ魔女どれみ
マジョハート	おジャ魔女どれみ
天野こうた	おジャ魔女どれみ
服部四郎	おジャ魔女どれみ
ショーン	おジャ魔女どれみ
鷹ノ宮ありさ	お兄ちゃんだけど愛さえあれば関係ないよねっ
姫小路秋人	お兄ちゃんだけど愛さえあれば関係ないよねっ
神野薫子	お兄ちゃんだけど愛さえあれば関係ないよねっ
二階堂嵐	お兄ちゃんだけど愛さえあれば関係ないよねっ
那須原アナスタシア	お兄ちゃんだけど愛さえあれば関係ないよねっ
猿渡銀兵衛春臣	お兄ちゃんだけど愛さえあれば関係ないよねっ
高梨修輔	お兄ちゃんのことなんかぜんぜん好きじゃないんだからねっ!!
加藤春華	お兄ちゃんのことなんかぜんぜん好きじゃないんだからねっ!!
高梨奈緒	お兄ちゃんのことなんかぜんぜん好きじゃないんだからねっ!!
近藤繭佳	お兄ちゃんのことなんかぜんぜん好きじゃないんだからねっ!!
楠原尋乃	お兄ちゃんのことなんかぜんぜん好きじゃないんだからねっ!!
岸川啓一郎	お兄ちゃんのことなんかぜんぜん好きじゃないんだからねっ!!
早坂ルリ	お姉ちゃんが来た
水原朋也	お姉ちゃんが来た
藤咲美奈	お姉ちゃんが来た
望月マリナ	お姉ちゃんが来た
水原一香	お姉ちゃんが来た
アリウス	かいけつゾロリ
チンク	かいけつゾロリ
ディナ	かいけつゾロリ
原ゆたか	かいけつゾロリ
アーサー	かいけつゾロリ
コブル	かいけつゾロリ
ゾンビ	かいけつゾロリ
ドーベル	かいけつゾロリ
テイル	かいけつゾロリ
ノッコ	かいけつゾロリ
ゴメス	かいけつゾロリ
マロウ	かいけつゾロリ
神泉やす菜	かしまし_〜ガール・ミーツ・ガール〜
来栖とまり	かしまし_〜ガール・ミーツ・ガール〜
北岡ゆめ	かなめも
久地院美華	かなめも
西田はるか	かなめも
天野咲妃	かなめも
南ゆうき	かなめも
東ひなた	かなめも
直	かなめも
九条和音	かみちゃまかりん
しーちゃん	かみちゃまかりん
九条姫香	かみちゃまかりん
久我神	かみちゃまかりん
八島様	かみちゅ!
バイケン	からくり剣豪伝ムサシロード
コジロー	からくり剣豪伝ムサシロード
ウシワカ	からくり剣豪伝ムサシロード
リョウマ	からくり剣豪伝ムサシロード
かりあげ正太	かりあげクン
亀吉	がきデカ
清治	がきデカ
義一	がきデカ
としえ	がきデカ
上原むつき	がくえんゆーとぴあ_まなびストレート!
衛藤芽生	がくえんゆーとぴあ_まなびストレート!
稲森光香	がくえんゆーとぴあ_まなびストレート!
小鳥桃葉	がくえんゆーとぴあ_まなびストレート!
下嶋	がくえんゆーとぴあ_まなびストレート!
高田哲也	がんばれ!キッカーズ
徳光	がんばれ!キッカーズ
大地翔	がんばれ!キッカーズ
西村知美	がんばれ!キッカーズ
朱里	がんばれ!キッカーズ
石井健太	がんばれ!キッカーズ
ユキエ	がんばれ!キッカーズ
畑中	がんばれ!キッカーズ
ゴエモンインパクト	がんばれゴエモン
ヤエ	がんばれゴエモン
カブキ	がんばれゴエモン
堀口元気	がんばれ元気
一弥	きまぐれオレンジ☆ロード
鮎川まどか	きまぐれオレンジ☆ロード
あかね	きまぐれオレンジ☆ロード
しおり	きまぐれオレンジ☆ロード
春日まなみ	きまぐれオレンジ☆ロード
春日恭介	きまぐれオレンジ☆ロード
九条カレン	きんいろモザイク
大宮勇	きんいろモザイク
猪熊空太	きんいろモザイク
小路綾	きんいろモザイク
猪熊陽子	きんいろモザイク
久世橋朱里	きんいろモザイク
松原穂乃花	きんいろモザイク
烏丸さくら	きんいろモザイク
猪熊美月	きんいろモザイク
アリス・カータレット	きんいろモザイク
ミーコ	きんぎょ注意報!
文太	きんぎょ注意報!
溝口	きんぎょ注意報!
わぴこ	きんぎょ注意報!
北田秀一	きんぎょ注意報!
藤ノ宮千歳	きんぎょ注意報!
菅平由梨香	きんぎょ注意報!
朱子	きんぎょ注意報!
加藤智恵子	きんぎょ注意報!
浅羽	きんぎょ注意報!
ぎょぴ	きんぎょ注意報!
銀太郎	ぎんぎつね
船橋日輪子	ぎんぎつね
冴木達夫	ぎんぎつね
金次郎	ぎんぎつね
池上ユミ	ぎんぎつね
神尾悟	ぎんぎつね
冴木まこと	ぎんぎつね
高見義友	ぎんぎつね
乙松	ぎんぎつね
河口紀美	けいおん!
堀込先生	けいおん!
秋山澪	けいおん!
一文字とみ	けいおん!
田井中聡	けいおん!
真鍋和	けいおん!
山中さわ子	けいおん!
中野梓	けいおん!
田井中律	けいおん!
平沢唯	けいおん!
川上	けいおん!
曽我部恵	けいおん!
琴吹紬	けいおん!
鈴木純	けいおん!
平沢憂	けいおん!
星野ひとみ	けいおん!
雨子	けろっこデメタン
美嶋紅音	けんぷファー
近堂水琴	けんぷファー
三郷雫	けんぷファー
斑目晴信	げんしけん
大野加奈子	げんしけん
沢渡	げんしけん
播磨	げんしけん
沢崎	げんしけん
春日部咲	げんしけん
今野	げんしけん
草野	げんしけん
矢島美怜	げんしけん
三上	げんしけん
高坂真琴	げんしけん
久我山光紀	げんしけん
波戸賢二郎	げんしけん
美作	げんしけん
北川	げんしけん
高柳	げんしけん
風祭サクヤ	こいこい7
猪飼ヒフミ	こいこい7
鈴鹿アキヲ	こいこい7
田中翔	こいこい7
田中哲朗	こいこい7
太田黒	こちら葛飾区亀有公園前派出所
山田理絵	こっちむいて!みい子
山田みい子	こっちむいて!みい子
ルー	こてんこてんこ
女王様	こてんこてんこ
ナッパ	こてんこてんこ
ムームー	こてんこてんこ
鈴木まみ	こどものおもちゃ
小花美穂	こどものおもちゃ
松井風花	こどものおもちゃ
ゲイリー・ハミルトン	こどものおもちゃ
綾乃花丸小路智美	こどものおもちゃ
飛田まゆ	こどものおもちゃ
ばびっと	こどものおもちゃ
倉田実紗子	こどものおもちゃ
杉田亜矢	こどものおもちゃ
羽山秋人	こどものおもちゃ
幸司	こどものおもちゃ
松岡昌宏	こどものおもちゃ
相模玲	こどものおもちゃ
篠原ともえ	こどものおもちゃ
内山田	こどものおもちゃ
ぜんじろう	こどものおもちゃ
倉田紗南	こどものおもちゃ
五條武史	こどものおもちゃ
宝院京子	こどものじかん
九重りん	こどものじかん
宇佐美々	こどものじかん
鏡黒	こどものじかん
水谷衣楠	この中に1人、妹がいる!
宝生柚璃奈	この中に1人、妹がいる!
帝野将悟	この中に1人、妹がいる!
嵯峨良芽依	この中に1人、妹がいる!
新谷	この中に1人、妹がいる!
セドル	この素晴らしい世界に祝福を!
ダクネス	この素晴らしい世界に祝福を!
テイラー	この素晴らしい世界に祝福を!
めぐみん	この素晴らしい世界に祝福を!
ガリル	この素晴らしい世界に祝福を!
アカリ	この醜くも美しい世界
宮田	こばと。
満里奈	こばと。
義男	こばと。
花戸小鳩	こばと。
俊彦	こばと。
三原千世	こばと。
柚原このみ	こみっくパーティー
沢渡いずみ	これが私の御主人様
沢渡みつき	これが私の御主人様
倉内安奈	これが私の御主人様
三原かなみ	これはゾンビですか?
アリエル	これはゾンビですか?
サラスバティ	これはゾンビですか?
ネグレリア・ネビロス	これはゾンビですか?
平松妙子	これはゾンビですか?
下村	これはゾンビですか?
アン・シャーリー	こんにちは_アン_〜Before_Green_Gables
ちゃまめっち	さぁイコー!_たまごっち
まきこ	さぁイコー!_たまごっち
ござるっち	さぁイコー!_たまごっち
めめっち	さぁイコー!_たまごっち
くろまめっち	さぁイコー!_たまごっち
ふらわっち	さぁイコー!_たまごっち
ムーア	さくらももこ劇場コジコジ
コロ助	さくらももこ劇場コジコジ
太郎	さくらももこ劇場コジコジ
次郎	さくらももこ劇場コジコジ
吾作	さくらももこ劇場コジコジ
テル子	さくらももこ劇場コジコジ
ひな子	さくらももこ劇場コジコジ
リタ・エインズワース	さくら荘のペットな彼女
長谷栞奈	さくら荘のペットな彼女
三鷹仁	さくら荘のペットな彼女
神田空太	さくら荘のペットな彼女
神田明子	さくら荘のペットな彼女
赤坂龍之介	さくら荘のペットな彼女
メイドちゃん	さくら荘のペットな彼女
桃子	さくら荘のペットな彼女
神田優子	さくら荘のペットな彼女
千石千尋	さくら荘のペットな彼女
青山七海	さくら荘のペットな彼女
月読呪々	ささみさん@がんばらない
月読鎖々美	ささみさん@がんばらない
蝦怒川情雨	ささみさん@がんばらない
淡島	ささみさん@がんばらない
月読神臣	ささみさん@がんばらない
蒼井あずさ	ささめきこと
霧賀魔子	さすがの猿飛
江川	さすらいの太陽
澄代	さすらいの太陽
慎介	さすらいの太陽
ゆき子	さすらいの太陽
一夫	さすらいの太陽
つね	さすらいの太陽
静子	さすらいの太陽
大次郎	さすらいの太陽
ブラス	さすらいの少女ネル
ヤミー	さばげぶっ!
豪徳寺かよ	さばげぶっ!
犬神	さばげぶっ!
羽黒露世理亜	さばげぶっ!
からあげ☆レモン	さばげぶっ!
春日野うらら	さばげぶっ!
仁	さらい屋_五葉
秋津政之助	さらい屋_五葉
九平	さらい屋_五葉
弥一	さらい屋_五葉
お絹	さらい屋_五葉
左王子蘭子	さんかれあ
散華団一郎	さんかれあ
ばーぶ	さんかれあ
降谷萌路	さんかれあ
降谷茹五郎	さんかれあ
茂木	さんかれあ
秋野	さんかれあ
来宮・ダリン・アーシェント	さんかれあ
夏川	さんかれあ
散華礼弥	さんかれあ
散華亜里亜	さんかれあ
ミズホ	しあわせソウのオコジョさん
コジョルー	しあわせソウのオコジョさん
太郎丸	しあわせソウのオコジョさん
古田	しおんの王
安岡紫音	しおんの王
斉藤歩	しおんの王
横山	しおんの王
亀井	しおんの王
なほ	しばいぬ子さん
ゆか	しゅごキャラ!
石井大輔	しゅごキャラ!
桜井優亜	しゅごキャラ!
詩音	しゅごキャラ!
翔太	しゅごキャラ!
山吹沙綾	しゅごキャラ!
まなみ	しゅごキャラ!
桐野	しろくまカフェ
ラマ	しろくまカフェ
ペン子	しろくまカフェ
マンドリル	しろくまカフェ
レッサーパンダ	しろくまカフェ
月子	しろくまカフェ
メイメイ	しろくまカフェ
半田	しろくまカフェ
小鉄	じゃりン子チエ
タカシ	じゃりン子チエ
小林マサル	じゃりン子チエ
竹本チエ	じゃりン子チエ
海老蔵	じょしらく
テツandトモ	すすめ!キッチン戦隊クックルン
サンチョ	ずっこけナイトドンデラマンチャ
北川理央	せんせいのお時間
渡部匠	せんせいのお時間
工藤雄一	せんせいのお時間
藤岡	せんせいのお時間
中山千夏	せんせいのお時間
小林あかね	せんせいのお時間
富永美奈子	せんせいのお時間
中村元	せんせいのお時間
なめざえもん	ぜんまいざむらい
ずきんちゃん	ぜんまいざむらい
わたあめひめ	ぜんまいざむらい
雪乃	ぜんまいざむらい
豆丸	ぜんまいざむらい
かみちよねーさん	ぜんまいざむらい
綿抜フウリ	そにアニ_-SUPER_SONICO_THE_ANIMATION-
富士見鈴	そにアニ_-SUPER_SONICO_THE_ANIMATION-
北村	そにアニ_-SUPER_SONICO_THE_ANIMATION-
三島木洋	そふてにっ
三吉杏子	そふてにっ
秋山千歳	そふてにっ
平岸やよい	そふてにっ
平塚由良	そふてにっ
エリザベス・ウォーレン	そふてにっ
土田祥子	そふてにっ
天地玲緒	そふてにっ
西岡紫希	そふてにっ
冬川来栖	そふてにっ
春風明日菜	そふてにっ
風音日和	そらのおとしもの
五月田根美香子	そらのおとしもの
アストレア	そらのおとしもの
ダイダロス	そらのおとしもの
マキコ	そらのおとしもの
イカロス	そらのおとしもの
ミーノース	そらのおとしもの
竹原	そらのおとしもの
守形英四郎	そらのおとしもの
アレサ	それが声優!
ミランダ	それでも世界は美しい
リーザ	それでも世界は美しい
アキ	それでも世界は美しい
カール	それでも世界は美しい
ミーナ	それでも世界は美しい
シーラ	それでも世界は美しい
リヴィウス・オルヴィヌス・イフリキア	それでも世界は美しい
嵐山猛	それでも町は廻っている
嵐山歩鳥	それでも町は廻っている
伊勢崎恵梨	それでも町は廻っている
針原春江	それでも町は廻っている
紺双葉	それでも町は廻っている
亀井堂静	それでも町は廻っている
磯端善治	それでも町は廻っている
辰野俊子	それでも町は廻っている
真田広章	それでも町は廻っている
森秋夏彦	それでも町は廻っている
松田旬作	それでも町は廻っている
関智一	それゆけ!_外道乙女隊
白鳳院綾乃エリザベス	それゆけ!宇宙戦艦ヤマモト・ヨーコ
御堂まどか	それゆけ!宇宙戦艦ヤマモト・ヨーコ
メオ・ニスのロート	それゆけ!宇宙戦艦ヤマモト・ヨーコ
常盤みどり	たまこまーけっと
朝霧史織	たまこまーけっと
清水富雄	たまこまーけっと
常盤信彦	たまこまーけっと
竜也	たまこまーけっと
牧野かんな	たまこまーけっと
大路吾平	たまこまーけっと
八百比邦夫	たまこまーけっと
大路もち蔵	たまこまーけっと
北白川あんこ	たまこまーけっと
北白川豆大	たまこまーけっと
大路道子	たまこまーけっと
かえで	たまこまーけっと
満村文子	たまこまーけっと
チョイ・モチマッヅィ	たまこまーけっと
湯本さゆり	たまこまーけっと
北白川福	たまこまーけっと
花瀬かおる	たまこまーけっと
デラ・モチマッヅィ	たまこまーけっと
リサラ・レストール	だから僕は、Hができない。
大平	だから僕は、Hができない。
夏美	だんちがい
春花	だんちがい
お兄ちゃん	だんちがい
稲田	ちとせげっちゅ!!
しのぶ	ちとせげっちゅ!!
みさき	ちとせげっちゅ!!
宅間	ちはやふる
甘糟那由太	ちはやふる
佐野	ちはやふる
さとこ	ちはやふる
駒野勉	ちはやふる
西田優征	ちはやふる
大江奏	ちはやふる
柴田	ちはやふる
安田	ちはやふる
田代	ちはやふる
坪口広史	ちはやふる
真島太一	ちはやふる
城山浩希	ちはやふる
勝義	ちはやふる
宮内妙子	ちはやふる
若宮詩暢	ちはやふる
由宇	ちはやふる
花野菫	ちはやふる
山川	ちはやふる
須藤暁人	ちはやふる
戸田	ちはやふる
吉岡	ちはやふる
立川梨理華	ちはやふる
綿谷始	ちはやふる
的場	ちはやふる
林田	ちはやふる
木梨浩	ちはやふる
桜沢翠	ちはやふる
大輔	ちはやふる
綿谷新	ちはやふる
筑波秋博	ちはやふる
逢坂恵夢	ちはやふる
伊藤先生	ちび☆デビ!
杉崎真	ちび☆デビ!
内田りな	ちび☆デビ!
ライちゃん	ちび☆デビ!
ペペ	ちび☆デビ!
まおちゃん	ちび☆デビ!
大熊	ちゅーぶら!!
嶋田	ちゅーぶら!!
小町陽樹	ちゅーぶら!!
コータ	ちゅーぶら!!
天原清乃	ちゅーぶら!!
神宮寺弥子	ちゅーぶら!!
谷原	ちゅーぶら!!
白石遥	ちゅーぶら!!
蛯原愛	ちょぼらうにょぽみ劇場_あいまいみー
麻衣	ちょぼらうにょぽみ劇場_あいまいみー
ちょぼらうにょぽみ	ちょぼらうにょぽみ劇場_あいまいみー
ウララ	つり球
宇佐美保	つり球
井上歩	つり球
島野海咲	つり球
宇佐美さくら	つり球
アキラ・アガルカール・山田	つり球
ココ	つり球
ハル	つり球
宇佐美夏樹	つり球
園田萌舞子	てさぐれ!部活もの
円城寺結衣	てさぐれ!部活もの
佐藤陽菜	てさぐれ!部活もの
高橋葵	てさぐれ!部活もの
田中心春	てさぐれ!部活もの
有栖川凛	てさぐれ!部活もの
宇佐美陽菜	てさぐれ!部活もの
芝草宇宙	てーきゅう
佐藤くるみ	てーきゅう
板東まりも	てーきゅう
マッドネス	てーきゅう
ミカさん	てーきゅう
高宮なすの	てーきゅう
鈴木あやこ	てーきゅう
トム	てーきゅう
西新井大師西	てーきゅう
トマリン	てーきゅう
近藤うどん子	てーきゅう
ボビー	てーきゅう
田中きなこ	てーきゅう
新庄かなえ	てーきゅう
押本陽太	てーきゅう
白井黒子	とある科学の超電磁砲
青髪ピアス	とある科学の超電磁砲
初春飾利	とある科学の超電磁砲
黒妻綿流	とある科学の超電磁砲
食蜂操祈	とある科学の超電磁砲
ジャーニー	とある科学の超電磁砲
婚后光子	とある科学の超電磁砲
御坂妹	とある科学の超電磁砲
中邑	とある科学の超電磁砲
みのり	とある科学の超電磁砲
一方通行	とある科学の超電磁砲
重福省帆	とある科学の超電磁砲
黄泉川愛穂	とある科学の超電磁砲
上条当麻	とある科学の超電磁砲
佐天涙子	とある科学の超電磁砲
木山春生	とある科学の超電磁砲
姫神秋沙	とある科学の超電磁砲
布束砥信	とある科学の超電磁砲
月詠小萌	とある科学の超電磁砲
土御門舞夏	とある科学の超電磁砲
御坂美鈴	とある科学の超電磁砲
水谷隆也	となりの怪物くん
佐々原宗平	となりの怪物くん
三沢満善	となりの怪物くん
吉田春	となりの怪物くん
夏目あさ子	となりの怪物くん
水谷雫	となりの怪物くん
横井るみ	となりの関くん
関俊成	となりの関くん
紋次郎	ながされて藍蘭島
あき	ながされて藍蘭島
すず	ながされて藍蘭島
清正	ながされて藍蘭島
なつ	ながされて藍蘭島
雨宮ゆり子	ななか6/17
霰玉九里子	ななか6/17
凪原稔二	ななか6/17
氷室那由	ななか6/17
飯田橋博士	ななこSOS
小倉	ななこSOS
佐倉明	なるたる
小沢さとみ	なるたる
小森朋典	なるたる
古賀のり夫	なるたる
住吉加奈子	にゃんこい!
望月千鶴	にゃんこい!
高坂鈴	にゃんこい!
一ノ瀬凪	にゃんこい!
ミッチー	にゃんこい!
桐島朱莉	にゃんこい!
桐島琴音	にゃんこい!
水野楓	にゃんこい!
タソ	にゅるにゅる!!KAKUSENくん
苔姫	ぬらりひょんの孫
奴良若菜	ぬらりひょんの孫
牛頭丸	ぬらりひょんの孫
雨造	ぬらりひょんの孫
家長カナ	ぬらりひょんの孫
雪麗	ぬらりひょんの孫
珱姫	ぬらりひょんの孫
ぬらりひょん	ぬらりひょんの孫
花開院秋房	ぬらりひょんの孫
花開院魔魅流	ぬらりひょんの孫
鳥居夏実	ぬらりひょんの孫
奴良鯉伴	ぬらりひょんの孫
花開院ゆら	ぬらりひょんの孫
ガゴゼ	ぬらりひょんの孫
なまはげ	ぬらりひょんの孫
トサカ丸	ぬらりひょんの孫
頼道	ぬらりひょんの孫
馬頭丸	ぬらりひょんの孫
羽衣狐	ぬらりひょんの孫
黒田坊	ぬらりひょんの孫
首無	ぬらりひょんの孫
3の口	ぬらりひょんの孫
良太猫	ぬらりひょんの孫
青田坊	ぬらりひょんの孫
巻紗織	ぬらりひょんの孫
濡鴉	ぬらりひょんの孫
毛倡妓	ぬらりひょんの孫
土彦	ぬらりひょんの孫
花開院竜二	ぬらりひょんの孫
山吹乙女	ぬらりひょんの孫
佐藤香苗	のうりん
戸次菜摘	のうりん
木下林檎	のうりん
良田胡蝶	のうりん
中沢農	のうりん
柿崎	のうりん
過真鳥継	のうりん
畑耕作	のうりん
ジェームズ・デプリースト	のだめカンタービレ
田中真紀子	のだめカンタービレ
千秋真一	のだめカンタービレ
峰龍太郎	のだめカンタービレ
エリーゼ	のだめカンタービレ
野田恵	のだめカンタービレ
ブル連隊長	のらくろクン
ブロッサム	のらみみ
トマゴメ	のらみみ
黒丸	のらみみ
更科	のらみみ
カメチョビン	のらみみ
まめぺん	のらみみ
チェルシー	のらみみ
カパユキ	のらみみ
ドッタリ君	のらみみ
ライオネル	のらみみ
ヘイホーコン	のらみみ
おたまじゃくそん	のらみみ
半田トシオ	のらみみ
加賀山楓	のんのんびより
越谷夏海	のんのんびより
宮内ひかげ	のんのんびより
宮内一穂	のんのんびより
越谷雪子	のんのんびより
一条蛍	のんのんびより
石川ほのか	のんのんびより
富士宮このみ	のんのんびより
越谷小鞠	のんのんびより
大河内	はいからさんが通る
藤枝蘭丸	はいからさんが通る
花村	はいからさんが通る
花村紅緒	はいからさんが通る
ラーナ	はいたい七葉
七瀬遥	はぐれ勇者の鬼畜美学
リスティ・エル・ダ・シェルフィード	はぐれ勇者の鬼畜美学
ワルキュリア	はぐれ勇者の鬼畜美学
ドテチン	はじめ人間ギャートルズ
志波美輝	はたらく魔王さま!
エメラダ・エトゥーヴァ	はたらく魔王さま!
佐々木千穂	はたらく魔王さま!
ノルド・ユスティーナ	はたらく魔王さま!
鈴木梨香	はたらく魔王さま!
沖まひる	はっぴぃセブン_〜ざ・テレビまんが〜
ビシャモン	はっぴぃセブン_〜ざ・テレビまんが〜
ドクロッピ	はっぴーカッピ
木下スグリ	はっぴーカッピ
持田あん	はっぴーカッピ
ポル	はなかっぱ
田中先生	はなかっぱ
アゲルちゃん	はなかっぱ
ももかっぱちゃん	はなかっぱ
ももかっぱちゃんのお兄さん	はなかっぱ
カラバッチョ	はなかっぱ
てれてれぼうず	はなかっぱ
がりぞー	はなかっぱ
土田直純	はなまる幼稚園
山本菜々子	はなまる幼稚園
川代	はなまる幼稚園
山本真弓	はなまる幼稚園
健一	はなまる幼稚園
良太	はなまる幼稚園
土田さつき	はなまる幼稚園
鬼丸	ばくはつ五郎
木戸浩志	ばらかもん
大浜謙太郎	ばらかもん
英助	ばらかもん
新井珠子	ばらかもん
川藤鷹生	ばらかもん
半田清明	ばらかもん
琴石なる	ばらかもん
山村巌	ばらかもん
半田えみ	ばらかもん
新井明彦	ばらかもん
山村美和	ばらかもん
久保田陽菜	ばらかもん
池澤	ひだまりスケッチ
有沢	ひだまりスケッチ
皆口	ひだまりスケッチ
健人	ひだまりスケッチ
岸麻衣子	ひだまりスケッチ
中山	ひだまりスケッチ
益子	ひだまりスケッチ
宮子	ひだまりスケッチ
沙英	ひだまりスケッチ
直居	ひだまりスケッチ
チカ子	ひみつのアッコちゃん
ガンモ	ひみつのアッコちゃん
ドラ	ひみつのアッコちゃん
変なおじさん	ひみつのアッコちゃん
キーオ	ひみつのアッコちゃん
有川かぐや	ひめゴト
織田光永	ひめゴト
有川ひめ	ひめゴト
カケル	ひめチェン!おとぎちっくアイドル_リルぷりっ
マモル	ひめチェン!おとぎちっくアイドル_リルぷりっ
ラビッツ	ひめチェン!おとぎちっくアイドル_リルぷりっ
雪森りんご	ひめチェン!おとぎちっくアイドル_リルぷりっ
グレーテル	ひめチェン!おとぎちっくアイドル_リルぷりっ
金田一	ひめチェン!おとぎちっくアイドル_リルぷりっ
笹原名月	ひめチェン!おとぎちっくアイドル_リルぷりっ
高城レイラ	ひめチェン!おとぎちっくアイドル_リルぷりっ
ダイ	ひめチェン!おとぎちっくアイドル_リルぷりっ
ヘンゼル	ひめチェン!おとぎちっくアイドル_リルぷりっ
ハムレット	ひめチェン!おとぎちっくアイドル_リルぷりっ
ちくタン	びんちょうタン
紫亜	ぴたテン
植松小星	ぴたテン
綾小路天	ぴたテン
美紗	ぴたテン
ニャー	ぴたテン
ムック	ふぉうちゅんドッグす
グレース	ふぉうちゅんドッグす
ビーチャン	ふぉうちゅんドッグす
リョーマ	ふぉうちゅんドッグす
トミコ	ふぉうちゅんドッグす
コースケ	ふぉうちゅんドッグす
コワルスキー	ふぉうちゅんドッグす
ユーピー	ふぉうちゅんドッグす
ブルート	ふぉうちゅんドッグす
モーツァルト	ふしぎな島のフローネ
シュワルツ	ふしぎな島のフローネ
エドワード	ふしぎな島のフローネ
タムタム	ふしぎな島のフローネ
エルシス・ラ・アルウォール	ふしぎの海のナディア
ネオ皇帝	ふしぎの海のナディア
ビナシス・ラ・アルウォール	ふしぎの海のナディア
イコリーナ・エッチーノ	ふしぎの海のナディア
グランディス・グランバァ	ふしぎの海のナディア
ネメシス・ラ・アルゴール	ふしぎの海のナディア
ハンソン	ふしぎの海のナディア
エーコー・ウィラン	ふしぎの海のナディア
イリオン	ふしぎの海のナディア
ジャン・ロック・ラルティーグ	ふしぎの海のナディア
メディナ・ラ・ルゲンシウス・エレクトラ	ふしぎの海のナディア
イコリーナ	ふしぎの海のナディア
フェイト	ふしぎの海のナディア
夕城美朱	ふしぎ遊戯
本郷唯	ふしぎ遊戯
軫宿	ふしぎ遊戯
柳宿	ふしぎ遊戯
大杉鈴乃	ふしぎ遊戯
鬼宿	ふしぎ遊戯
小田島友華	ふたりはプリキュア
木村	ふたりはプリキュア
雪城さなえ	ふたりはプリキュア
矢部千秋	ふたりはプリキュア
越野夏子	ふたりはプリキュア
久保田志穂	ふたりはプリキュア
九条ひかり	ふたりはプリキュア
雪城ほのか	ふたりはプリキュア
ビブリス	ふたりはプリキュア
加賀山美羽	ふたりはプリキュア
藤村省吾	ふたりはプリキュア
竹野内よし美	ふたりはプリキュア
サーキュラス	ふたりはプリキュア
中尾	ふたりはプリキュア
谷口聖子	ふたりはプリキュア
高清水莉奈	ふたりはプリキュア
木俣	ふたりはプリキュア
ジャアクキング	ふたりはプリキュア
忠太郎	ふたりはプリキュア
バルデス	ふたりはプリキュア
植田	ふたりはプリキュア
ピーサード	ふたりはプリキュア
イルクーボ	ふたりはプリキュア
雪城文	ふたりはプリキュア
笹野	ふたりはプリキュア
レギーネ	ふたりはプリキュア
多幡奈緒	ふたりはプリキュア
小熊	ふたりはプリキュア
雪城太郎	ふたりはプリキュア
ウィズダム	ふたりはプリキュア
美墨岳	ふたりはプリキュア
藤田アカネ	ふたりはプリキュア
大輝	ふたりはプリキュア
甘井	ふたりはプリキュア
森京子	ふたりはプリキュア
中川弓子	ふたりはプリキュア
美墨理恵	ふたりはプリキュア
ウラガノス	ふたりはプリキュア
ゲキドラーゴ	ふたりはプリキュア
永沢勝子	ふたりはプリキュア
メグミ	ふたりはプリキュア
ポイズニー	ふたりはプリキュア
アクダイカーン	ふたりはプリキュア_Splash_Star
霧生薫	ふたりはプリキュア_Splash_Star
星野健太	ふたりはプリキュア_Splash_Star
安藤加代	ふたりはプリキュア_Splash_Star
ミズ・シタターレ	ふたりはプリキュア_Splash_Star
ドロドロン	ふたりはプリキュア_Splash_Star
太田優子	ふたりはプリキュア_Splash_Star
日向沙織	ふたりはプリキュア_Splash_Star
鈴木明日香	ふたりはプリキュア_Splash_Star
キントレスキー	ふたりはプリキュア_Splash_Star
泉田	ふたりはプリキュア_Splash_Star
フィーリア	ふたりはプリキュア_Splash_Star
宮迫学	ふたりはプリキュア_Splash_Star
霧生満	ふたりはプリキュア_Splash_Star
山口真理	ふたりはプリキュア_Splash_Star
日向みのり	ふたりはプリキュア_Splash_Star
友也	ふたりはプリキュア_Splash_Star
岡井	ふたりはプリキュア_Splash_Star
伊東仁美	ふたりはプリキュア_Splash_Star
カレハーン	ふたりはプリキュア_Splash_Star
篠原	ふたりはプリキュア_Splash_Star
日向大介	ふたりはプリキュア_Splash_Star
モエルンバ	ふたりはプリキュア_Splash_Star
美翔可南子	ふたりはプリキュア_Splash_Star
ゴーヤーン	ふたりはプリキュア_Splash_Star
美翔和也	ふたりはプリキュア_Splash_Star
真紀	ふたり暮らし
里華	ふたり暮らし
デビッド・アルダナ	ふたり鷹
ふなっしー	ふなっしーのふなふなふな日和
シンディ	ぶぶチャチャ
ティム	ぶぶチャチャ
ブル	ぶぶチャチャ
ベルベル	ぷちぷり*ユーシィ
エルミナ	ぷちぷり*ユーシィ
ガガ	ぷちぷり*ユーシィ
ベス	ぷちぷり*ユーシィ
グレンダ	ぷちぷり*ユーシィ
黒田如水	へうげもの
榊原康政	へうげもの
織田有楽斎	へうげもの
山上宗二	へうげもの
長谷川等伯	へうげもの
北条氏直	へうげもの
茶屋四郎次郎	へうげもの
本阿弥光悦	へうげもの
本多忠勝	へうげもの
南光坊天海	へうげもの
細川忠興	へうげもの
加藤清正	へうげもの
今井宗久	へうげもの
織田信雄	へうげもの
織田信忠	へうげもの
高台院	へうげもの
石川数正	へうげもの
淀殿	へうげもの
長次郎	へうげもの
おせん	へうげもの
毛利輝元	へうげもの
秋月種実	へうげもの
中川清秀	へうげもの
高山右近	へうげもの
丹羽長秀	へうげもの
津田宗及	へうげもの
豊臣秀長	へうげもの
細川幽斎	へうげもの
福島正則	へうげもの
滝川一益	へうげもの
六本松	へっぽこ実験アニメーション_エクセル♥サーガ
六道神士	へっぽこ実験アニメーション_エクセル♥サーガ
アレアレ	へろへろくん
榊光輝	べるぜバブ
新庄・アレックス・ロドリゲス・一郎	べるぜバブ
コマちゃん	べるぜバブ
阿倍	べるぜバブ
郷宏道	べるぜバブ
嶋村	べるぜバブ
グラフェル	べるぜバブ
出馬要	べるぜバブ
中田	べるぜバブ
男鹿辰巳	べるぜバブ
東条英虎	べるぜバブ
畑山	べるぜバブ
梅宮薫	べるぜバブ
花澤由加	べるぜバブ
大森寧々	べるぜバブ
谷村千秋	べるぜバブ
レイミア	べるぜバブ
夏目慎太郎	べるぜバブ
邦枝葵	べるぜバブ
神崎一	べるぜバブ
下川	べるぜバブ
ヒルデガルダ	べるぜバブ
古市ほのか	べるぜバブ
邦枝光太	べるぜバブ
蓮井	べるぜバブ
三木久也	べるぜバブ
古市貴之	べるぜバブ
陣野かおる	べるぜバブ
高橋	べるぜバブ
山村和也	べるぜバブ
早乙女禅十郎	べるぜバブ
ケツァルコアトル	べるぜバブ
カイゼル・デ・エンペラーナ・ベルゼバブ4世	べるぜバブ
加藤竜太	ぺとぺとさん
沙原くぐる	ぺとぺとさん
古茂田孝美	ぼくらの
往住愛子	ぼくらの
阿野万記	ぼくらの
小高勝	ぼくらの
町洋子	ぼくらの
宇白可奈	ぼくらの
宇白順	ぼくらの
小田	ぼくらの
本田千鶴	ぼくらの
さん	ぼのぼの
くん	ぼのぼの
ゴンゾ	ぼのぼの
ぼのぼののおとうさん	ぼのぼの
アライグマくんのおとうさん	ぼのぼの
ショーねえちゃん	ぼのぼの
ダイねえちゃん	ぼのぼの
春日乃ねね	ぽてまよ
ぐちゅ子	ぽてまよ
高見盛京	ぽてまよ
蜂谷美美	ぽてまよ
犬山	ぽてまよ
桐原無道	ぽてまよ
初芝薫	ぽてまよ
森山未来	ぽてまよ
木下茂	ぽぽたん
メアー	ぽぽたん
みい	ぽぽたん
メイド長	まおゆう魔王勇者
女騎士	まおゆう魔王勇者
火竜公女	まおゆう魔王勇者
女魔法使い	まおゆう魔王勇者
冬寂王	まおゆう魔王勇者
青年商人	まおゆう魔王勇者
ミヤビ	まかでみ・WAっしょい!
郷津	まじっく快斗
紺野エリカ	まじっく快斗
黒羽快斗	まじっく快斗
中森青子	まじっく快斗
白馬探	まじっく快斗
中森銀三	まじっく快斗
小泉紅子	まじっく快斗
工藤新一	まじっく快斗
江戸川コナン	まじっく快斗
茶木神太郎	まじっく快斗
藤江	まじっく快斗
桃井恵子	まじっく快斗
黒羽千影	まじっく快斗
スネイク	まじっく快斗
バーガー	まじめにふまじめ_かいけつゾロリ
デイジー姫	まじめにふまじめ_かいけつゾロリ
銀太	まじめにふまじめ_かいけつゾロリ
ルルー	まじめにふまじめ_かいけつゾロリ
ジョーダン	まじめにふまじめ_かいけつゾロリ
ラッツ	まじめにふまじめ_かいけつゾロリ
ニャンガ	まじめにふまじめ_かいけつゾロリ
カヨ	まじめにふまじめ_かいけつゾロリ
ブルック	まじめにふまじめ_かいけつゾロリ
ディアリー	まじめにふまじめ_かいけつゾロリ
赤鬼	まじめにふまじめ_かいけつゾロリ
井上澄子	まじもじるるも
ハルリリ	まじもじるるも
るるも	まじもじるるも
鯨井棚子	まじもじるるも
柴木耕太	まじもじるるも
セバスチャン	まっすぐにいこう。
マメタロウ	まっすぐにいこう。
源	まっすぐにいこう。
山瀬千早	まぶらほ
栗丘舞穂	まぶらほ
等々力凛	まほろまてぃっく
佐倉深雪	まほろまてぃっく
大江千鶴子	まほろまてぃっく
大門隼人	まほろまてぃっく
ありす	まめうしくん
ゴウ	まもって!ロリポップ
野村たかし	まもって守護月天!
離珠	まもって守護月天!
七梨太助	まもって守護月天!
坂町紅羽	まよチキ!
宇佐美マサムネ	まよチキ!
黒瀬ヤマト	まよチキ!
涼月奏	まよチキ!
坂町近次郎	まよチキ!
稲森弓弦	まりあ†ほりっく
殿村	まりあ†ほりっく
与那国	まりあ†ほりっく
助三郎	まんが_水戸黄門
モグタン	まんがはじめて物語
西島りんご	まんがーる!
佐々山はな	まんがーる!
立花杏子	みかん絵日記
こりんご	みかん絵日記
キリー	みかん絵日記
モリー	みかん絵日記
賢三	みかん絵日記
カルマ	みかん絵日記
栗山愛子	みつどもえ
丸井草次郎	みつどもえ
ガチイエロー	みつどもえ
千葉雄大	みつどもえ
杉崎麻里奈	みつどもえ
杉崎みく	みつどもえ
加藤真由美	みつどもえ
宮下	みつどもえ
海江田先生	みつどもえ
緒方愛梨	みつどもえ
ガチピンク	みつどもえ
杉崎龍太	みつどもえ
丸井ひとは	みつどもえ
吉岡ゆき	みつどもえ
佐藤あかり	みつどもえ
田渕	みつどもえ
丸井ふたば	みつどもえ
松岡咲子	みつどもえ
吉岡紗江子	みつどもえ
メグちゃん	みつどもえ
丸井みつば	みつどもえ
矢部智	みつどもえ
佐藤信也	みつどもえ
伊藤詩織	みつどもえ
内田ユカ	みなみけ
アツコ	みなみけ
南冬馬	みなみけ
速水	みなみけ
南ナツキ	みなみけ
ユウ	みなみけ
南アキラ	みなみけ
南夏奈	みなみけ
南春香	みなみけ
ミユキ	みなみけ
吉野	みなみけ
ヒトミ	みなみけ
ケイコ	みなみけ
保坂	みなみけ
南千秋	みなみけ
ヒロコ	みなみけ
トク	みらくる!_ぱんぞう
ソン	みらくる!_ぱんぞう
ユーシス・アルバレア	みんな集まれ!ファルコム学園
アンゼリカ・ログナー	みんな集まれ!ファルコム学園
ガイウス・ウォーゼル	みんな集まれ!ファルコム学園
ケビン・グラハム	みんな集まれ!ファルコム学園
ヨシュア・ブライト	みんな集まれ!ファルコム学園
リルル	みんな集まれ!ファルコム学園
フィー・クラウゼル	みんな集まれ!ファルコム学園
リース・アルジェント	みんな集まれ!ファルコム学園
ブルブラン	みんな集まれ!ファルコム学園
ロマンシア	みんな集まれ!ファルコム学園
オリビエ	みんな集まれ!ファルコム学園
エマ・ミルスティン	みんな集まれ!ファルコム学園
グース	みんな集まれ!ファルコム学園
アリアンロード	みんな集まれ!ファルコム学園
リィン・シュバルツァー	みんな集まれ!ファルコム学園
リーシャ・マオ	みんな集まれ!ファルコム学園
トヴァル・ランドナー	みんな集まれ!ファルコム学園
シャーラ	みんな集まれ!ファルコム学園
エリオット・クレイグ	みんな集まれ!ファルコム学園
マキアス・レーグニッツ	みんな集まれ!ファルコム学園
アガット・クロスナー	みんな集まれ!ファルコム学園
リリア	みんな集まれ!ファルコム学園
クルツ・ナルダン	みんな集まれ!ファルコム学園
ギリアス・オズボーン	みんな集まれ!ファルコム学園
エステル・ブライト	みんな集まれ!ファルコム学園
一の瀬賢太郎	めぞん一刻
八神いぶき	めぞん一刻
飯岡	めぞん一刻
一の瀬花枝	めぞん一刻
七尾こずえ	めぞん一刻
三鷹瞬	めぞん一刻
坂本	めぞん一刻
九条明日菜	めぞん一刻
音無響子	めぞん一刻
六本木朱美	めぞん一刻
音無惣一郎	めぞん一刻
平戸ロイヤル	めだかボックス
黒神めだか	めだかボックス
呼子笛	めだかボックス
鶴御崎山海	めだかボックス
須木奈佐木咲	めだかボックス
古賀いたみ	めだかボックス
蛇籠飽	めだかボックス
鬼瀬針音	めだかボックス
球磨川禊	めだかボックス
般若寺憂	めだかボックス
百町破魔矢	めだかボックス
屋久島有無路	めだかボックス
画図町筆	めだかボックス
都城王土	めだかボックス
牛深柄春	めだかボックス
種子島率	めだかボックス
人吉善吉	めだかボックス
黒神真黒	めだかボックス
雲仙冥利	めだかボックス
安心院なじみ	めだかボックス
阿蘇短冊	めだかボックス
直方賢理	めだかボックス
阿久根高貴	めだかボックス
雲仙冥加	めだかボックス
鍋島猫美	めだかボックス
対馬左脳	めだかボックス
高千穂仕種	めだかボックス
不知火半袖	めだかボックス
宗像形	めだかボックス
対馬右脳	めだかボックス
ダンボー	めちゃっこドタコン
シズク	もえたん
手塚澪	もえたん
瑠璃子	もえたん
田中里奈	もえたん
美穂	もえたん
滝本誠	もし高校野球の女子マネージャーがドラッカーの『マネジメント』を読んだら
北条文乃	もし高校野球の女子マネージャーがドラッカーの『マネジメント』を読んだら
川島みなみ	もし高校野球の女子マネージャーがドラッカーの『マネジメント』を読んだら
宮田夕紀	もし高校野球の女子マネージャーがドラッカーの『マネジメント』を読んだら
龍太	もやしもん
長谷川遥	もやしもん
田中恭子	もやしもん
及川葉月	もやしもん
樹慶蔵	もやしもん
宏岡亜矢	もやしもん
美里薫	もやしもん
結城蛍	もやしもん
川浜拓馬	もやしもん
折本かおり	やはり俺の青春ラブコメはまちがっている。
玉縄	やはり俺の青春ラブコメはまちがっている。
川崎沙希	やはり俺の青春ラブコメはまちがっている。
葉山隼人	やはり俺の青春ラブコメはまちがっている。
遥	やはり俺の青春ラブコメはまちがっている。
大岡	やはり俺の青春ラブコメはまちがっている。
平塚静	やはり俺の青春ラブコメはまちがっている。
櫟井唯	ゆゆ式
相川千穂	ゆゆ式
松本頼子	ゆゆ式
日向縁	ゆゆ式
長谷川ふみ	ゆゆ式
岡野佳	ゆゆ式
相田ゆるめ	ゆるめいつ_3でぃ
松吉	ゆるめいつ_3でぃ
杉浦綾乃	ゆるゆり
大室撫子	ゆるゆり
大室花子	ゆるゆり
歳納京子	ゆるゆり
北宮初美	ゆるゆり
吉川ちなつ	ゆるゆり
吉川ともこ	ゆるゆり
東志帆子	ゆるゆり
西垣奈々	ゆるゆり
松本りせ	ゆるゆり
大室櫻子	ゆるゆり
ガンボー	ゆるゆり
古谷楓	ゆるゆり
池田千歳	ゆるゆり
赤座あかね	ゆるゆり
船見結衣	ゆるゆり
船見まり	ゆるゆり
古谷向日葵	ゆるゆり
池田千鶴	ゆるゆり
赤座あかり	ゆるゆり
一ノ瀬・弓子・クリスティーナ	よくわかる現代魔法
坂崎嘉穂	よくわかる現代魔法
眠田ころん	よばれてとびでて!アクビちゃん
ハクション大魔王	よばれてとびでて!アクビちゃん
緒方	よみがえる空_-RESCUE_WINGS-
ゆみ	よみがえる空_-RESCUE_WINGS-
吉岡悟	よみがえる空_-RESCUE_WINGS-
内田正	よみがえる空_-RESCUE_WINGS-
五十嵐充	よろしくメカドック
中村一路	よろしくメカドック
早坂優	よろしくメカドック
ルシファー	よんでますよ、アザゼルさん。
堂珍光太郎	よんでますよ、アザゼルさん。
アザゼル	よんでますよ、アザゼルさん。
千波十美子	よんでますよ、アザゼルさん。
アンダイン	よんでますよ、アザゼルさん。
インキュバス	よんでますよ、アザゼルさん。
キヨコ	よんでますよ、アザゼルさん。
エウリノーム	よんでますよ、アザゼルさん。
佐隈りん子	よんでますよ、アザゼルさん。
ラファエル	よんでますよ、アザゼルさん。
モロク	よんでますよ、アザゼルさん。
星井ラミカ	らき☆すた
小野だいすけ	らき☆すた
黒井ななこ	らき☆すた
高良みゆき	らき☆すた
杉田店員	らき☆すた
柊まつり	らき☆すた
高良ゆかり	らき☆すた
柊つかさ	らき☆すた
峰岸あやの	らき☆すた
小早川ゆたか	らき☆すた
柊かがみ	らき☆すた
ゴットゥーザ様	らき☆すた
高橋豊	らき☆すた
岩崎みなみ	らき☆すた
宮河ひかげ	らき☆すた
成実ゆい	らき☆すた
日下部みさお	らき☆すた
泉かなた	らき☆すた
天原ふゆき	らき☆すた
泉そうじろう	らき☆すた
チュン	らき☆すた
宮河ひなた	らき☆すた
八坂こう	らき☆すた
永森やまと	らき☆すた
初音ミク	らき☆すた
藤田真琴	らぶドル_〜Lovely_Idol〜
榊瑞樹	らぶドル_〜Lovely_Idol〜
北条美奈	らぶドル_〜Lovely_Idol〜
進藤あゆみ	らぶドル_〜Lovely_Idol〜
真理子	らぶドル_〜Lovely_Idol〜
片桐沙有紀	らぶドル_〜Lovely_Idol〜
野々宮舞	らぶドル_〜Lovely_Idol〜
結城瞳子	らぶドル_〜Lovely_Idol〜
大路しずく	らぶドル_〜Lovely_Idol〜
成瀬雪見	らぶドル_〜Lovely_Idol〜
日渡あや	らぶドル_〜Lovely_Idol〜
有栖川唯	らぶドル_〜Lovely_Idol〜
北条比奈	らぶドル_〜Lovely_Idol〜
桐生琴葉	らぶドル_〜Lovely_Idol〜
北条知奈	らぶドル_〜Lovely_Idol〜
浅見ひびき	らぶドル_〜Lovely_Idol〜
藤沢瑠璃	らぶドル_〜Lovely_Idol〜
猫谷海羽	らぶドル_〜Lovely_Idol〜
岩崎ひろみ	らんぽう
あけみ	らんぽう
チュー太郎	らんぽう
翔	りぜるまいん
岩城友紀	りぜるまいん
月岡津南	るろうに剣心_-明治剣客浪漫譚-
柏崎念至	るろうに剣心_-明治剣客浪漫譚-
喜八	るろうに剣心_-明治剣客浪漫譚-
雪代縁	るろうに剣心_-明治剣客浪漫譚-
飯塚	るろうに剣心_-明治剣客浪漫譚-
新八	るろうに剣心_-明治剣客浪漫譚-
蜂須賀	るろうに剣心_-明治剣客浪漫譚-
石動雷十太	るろうに剣心_-明治剣客浪漫譚-
西条	るろうに剣心_-明治剣客浪漫譚-
白石	るろうに剣心_-明治剣客浪漫譚-
三条燕	るろうに剣心_-明治剣客浪漫譚-
相楽左之助	るろうに剣心_-明治剣客浪漫譚-
亀雄	るろうに剣心_-明治剣客浪漫譚-
山吉盛典	るろうに剣心_-明治剣客浪漫譚-
勝海舟	るろうに剣心_-明治剣客浪漫譚-
新井伊織	るろうに剣心_-明治剣客浪漫譚-
クリス	るろうに剣心_-明治剣客浪漫譚-
西脇	るろうに剣心_-明治剣客浪漫譚-
四乃森蒼紫	るろうに剣心_-明治剣客浪漫譚-
徳川慶喜	るろうに剣心_-明治剣客浪漫譚-
関原妙	るろうに剣心_-明治剣客浪漫譚-
龍之介	るろうに剣心_-明治剣客浪漫譚-
高森	るろうに剣心_-明治剣客浪漫譚-
ヤス	るろうに剣心_-明治剣客浪漫譚-
猿次郎	るろうに剣心_-明治剣客浪漫譚-
塚山由太郎	るろうに剣心_-明治剣客浪漫譚-
山県有朋	るろうに剣心_-明治剣客浪漫譚-
緋村剣心	るろうに剣心_-明治剣客浪漫譚-
葛西	るろうに剣心_-明治剣客浪漫譚-
詩織	るろうに剣心_-明治剣客浪漫譚-
川路利良	るろうに剣心_-明治剣客浪漫譚-
戌亥番神	るろうに剣心_-明治剣客浪漫譚-
秀次	るろうに剣心_-明治剣客浪漫譚-
大久保利通	るろうに剣心_-明治剣客浪漫譚-
彦次郎	るろうに剣心_-明治剣客浪漫譚-
斎藤一	るろうに剣心_-明治剣客浪漫譚-
慎二	るろうに剣心_-明治剣客浪漫譚-
鵜堂刃衛	るろうに剣心_-明治剣客浪漫譚-
島田一郎	るろうに剣心_-明治剣客浪漫譚-
菊松	るろうに剣心_-明治剣客浪漫譚-
相楽総三	るろうに剣心_-明治剣客浪漫譚-
高杉晋作	るろうに剣心_-明治剣客浪漫譚-
神谷薫	るろうに剣心_-明治剣客浪漫譚-
銀次	るろうに剣心_-明治剣客浪漫譚-
堀田正睦	るろうに剣心_-明治剣客浪漫譚-
新井赤空	るろうに剣心_-明治剣客浪漫譚-
高荷恵	るろうに剣心_-明治剣客浪漫譚-
桂小五郎	るろうに剣心_-明治剣客浪漫譚-
岩蔵	るろうに剣心_-明治剣客浪漫譚-
乙和瓢湖	るろうに剣心_-明治剣客浪漫譚-
四季鏡沙織	れでぃ×ばと!
四季鏡早苗	れでぃ×ばと!
ヘディエ	れでぃ×ばと!
トン子	ろぼっ子ビートン
マーちゃん	ろぼっ子ビートン
ガキオヤジ	ろぼっ子ビートン
ブリキン	ろぼっ子ビートン
うららちゃん	ろぼっ子ビートン
黒川真魚	わかば*ガール
時田萌子	わかば*ガール
真柴直	わかば*ガール
小橋若葉	わかば*ガール
日高安純	わがまま☆フェアリー_ミルモでポン!
イチロー	わがまま☆フェアリー_ミルモでポン!
パンタ	わがまま☆フェアリー_ミルモでポン!
理恵	わがまま☆フェアリー_ミルモでポン!
サブロー	わがまま☆フェアリー_ミルモでポン!
南楓	わがまま☆フェアリー_ミルモでポン!
ムルモ	わがまま☆フェアリー_ミルモでポン!
マサコ	わがまま☆フェアリー_ミルモでポン!
アクア	わがまま☆フェアリー_ミルモでポン!
土田	わがまま☆フェアリー_ミルモでポン!
ミライ	わがまま☆フェアリー_ミルモでポン!
モグル	わがまま☆フェアリー_ミルモでポン!
夏夕介	わがまま☆フェアリー_ミルモでポン!
アテネ	わがまま☆フェアリー_ミルモでポン!
ラブリ	わがまま☆フェアリー_ミルモでポン!
アロマ	わがまま☆フェアリー_ミルモでポン!
真里奈	わがまま☆フェアリー_ミルモでポン!
結木摂	わがまま☆フェアリー_ミルモでポン!
ヤマネ	わがまま☆フェアリー_ミルモでポン!
ゴロー	わがまま☆フェアリー_ミルモでポン!
星野	わがまま☆フェアリー_ミルモでポン!
クロロ	わがまま☆フェアリー_ミルモでポン!
平井	わがまま☆フェアリー_ミルモでポン!
ジロー	わがまま☆フェアリー_ミルモでポン!
サリア	わがまま☆フェアリー_ミルモでポン!
コロロ	わがまま☆フェアリー_ミルモでポン!
チャイ	わがまま☆フェアリー_ミルモでポン!
住田光一	わがまま☆フェアリー_ミルモでポン!
トリさん	わが青春のアルカディア_無限軌道SSX
レビ	わが青春のアルカディア_無限軌道SSX
グリン	わが青春のアルカディア_無限軌道SSX
ハンス	わたしとわたし_ふたりのロッテ
ニーナ	わたしとわたし_ふたりのロッテ
モニカ	わたしとわたし_ふたりのロッテ
チルチル	わんぱく大昔クムクム
怪人二十面相	わんぱく探偵団
明智小五郎	わんぱく探偵団
クリムゾン・ダイナモ	アイアンマン
ジャスティン・ハマー	アイアンマン
エンシエロ篤	アイカツ!
瀬名翼	アイカツ!
藤山	アイカツ!
天羽あすか	アイカツ!
神代レイ	アイカツ!
有栖川おとめ	アイカツ!
光石織姫	アイカツ!
シュラト	アイカツ!
長谷川まつり	アイカツ!
霧矢あおい	アイカツ!
田中健太郎	アイカツ!
立花ミシェル	アイカツ!
花音	アイカツ!
栗栖ここね	アイカツ!
東あさひ	アイカツ!
星宮太一	アイカツ!
新城絵麻	アイカツ!
黒澤ミチル	アイカツ!
北大路左近	アイカツ!
紫吹蘭	アイカツ!
夏樹みくる	アイカツ!
橘杏奈	アイカツ!
細谷	アイカツ!
虹ヶ原マコト	アイカツ!
涼川直人	アイカツ!
四ツ葉春	アイカツ!
りおん	アイカツ!
中屋	アイカツ!
ジョニー別府	アイカツ!
村木	アイカツ!
三ノ輪ヒカリ	アイカツ!
星宮りんご	アイカツ!
堤なぎさ	アイカツ!
氷室朝美	アイカツ!
月影ほのか	アイカツ!
KAYOKO	アイカツ!
神崎美月	アイカツ!
狼谷大牙	アイシールド21
佐々木コータロー	アイシールド21
サイモン	アイシールド21
ホーマー・フィッツジェラルド	アイシールド21
ビッグベア	アイシールド21
筧駿	アイシールド21
沢井ジュリ	アイシールド21
葉柱斗影	アイシールド21
虎吉	アイシールド21
円子令司	アイシールド21
峨王力哉	アイシールド21
吉永	アイドルマスター_XENOGLOSSIA
秋月律子	アイドルマスター_XENOGLOSSIA
大道楢馬	アイドルマスター_XENOGLOSSIA
リファ	アイドルマスター_XENOGLOSSIA
朔響	アイドルマスター_XENOGLOSSIA
高槻やよい	アイドルマスター_XENOGLOSSIA
三浦あずさ	アイドルマスター_XENOGLOSSIA
鈴木空羽	アイドルマスター_XENOGLOSSIA
宗方名瀬	アイドルマスター_XENOGLOSSIA
双海真美	アイドルマスター_XENOGLOSSIA
安原蛍	アイドルマスター_XENOGLOSSIA
菊地真	アイドルマスター_XENOGLOSSIA
双海亜美	アイドルマスター_XENOGLOSSIA
堀裕子	アイドルマスター_シンデレラガールズ
佐藤心	アイドルマスター_シンデレラガールズ
高森藍子	アイドルマスター_シンデレラガールズ
木村夏樹	アイドルマスター_シンデレラガールズ
新田美波	アイドルマスター_シンデレラガールズ
櫻井桃華	アイドルマスター_シンデレラガールズ
小日向美穂	アイドルマスター_シンデレラガールズ
川島瑞樹	アイドルマスター_シンデレラガールズ
塩見周子	アイドルマスター_シンデレラガールズ
水本ゆかり	アイドルマスター_シンデレラガールズ
前川みく	アイドルマスター_シンデレラガールズ
中野有香	アイドルマスター_シンデレラガールズ
脇山珠美	アイドルマスター_シンデレラガールズ
姫川友紀	アイドルマスター_シンデレラガールズ
片桐早苗	アイドルマスター_シンデレラガールズ
大槻唯	アイドルマスター_シンデレラガールズ
諸星きらり	アイドルマスター_シンデレラガールズ
安部菜々	アイドルマスター_シンデレラガールズ
渋谷凛	アイドルマスター_シンデレラガールズ
藤本里奈	アイドルマスター_シンデレラガールズ
城ヶ崎莉嘉	アイドルマスター_シンデレラガールズ
双葉杏	アイドルマスター_シンデレラガールズ
松永涼	アイドルマスター_シンデレラガールズ
椎名法子	アイドルマスター_シンデレラガールズ
星輝子	アイドルマスター_シンデレラガールズ
上条春菜	アイドルマスター_シンデレラガールズ
神谷奈緒	アイドルマスター_シンデレラガールズ
佐久間まゆ	アイドルマスター_シンデレラガールズ
浜口あやめ	アイドルマスター_シンデレラガールズ
難波笑美	アイドルマスター_シンデレラガールズ
輿水幸子	アイドルマスター_シンデレラガールズ
佐々木千枝	アイドルマスター_シンデレラガールズ
鷺沢文香	アイドルマスター_シンデレラガールズ
三村かな子	アイドルマスター_シンデレラガールズ
日野茜	アイドルマスター_シンデレラガールズ
本田未央	アイドルマスター_シンデレラガールズ
高垣楓	アイドルマスター_シンデレラガールズ
神崎蘭子	アイドルマスター_シンデレラガールズ
山下秀樹	アイドル天使ようこそようこ
速水亮	アイドル天使ようこそようこ
全	アイドル天使ようこそようこ
山杜サキ	アイドル天使ようこそようこ
ガリウス・エン・コルドバル	アウトブレイク・カンパニー
加納慎一	アウトブレイク・カンパニー
古賀沼美埜里	アウトブレイク・カンパニー
エルビア・ハーナイマン	アウトブレイク・カンパニー
ペトラルカ・アン・エルダント三世	アウトブレイク・カンパニー
ロミルダ・ガルド	アウトブレイク・カンパニー
的場甚三郎	アウトブレイク・カンパニー
村尾修子	アオハライド
吉岡双葉	アオハライド
チエ	アオハライド
馬渕洸	アオハライド
内藤	アオハライド
田中陽一	アオハライド
槙田悠里	アオハライド
明日美	アオハライド
ラバック	アカメが斬る!
ナジェンダ	アカメが斬る!
リヴァ	アカメが斬る!
ウェイブ	アカメが斬る!
ニャウ	アカメが斬る!
ロクゴウ	アカメが斬る!
ブラート	アカメが斬る!
セリュー・ユビキタス	アカメが斬る!
Dr.スタイリッシュ	アカメが斬る!
ブドー	アカメが斬る!
ボルス	アカメが斬る!
エスデス	アカメが斬る!
天空寺なじみ	アキカン!
ぶど子	アキカン!
ミク	アキカン!
テツロー	アキハバラ電脳組
クリスチャン・ローゼンクロイツ	アキハバラ電脳組
フランチェスカ	アキハバラ電脳組
プティアンジュ	アキハバラ電脳組
アポロン	アクエリオンEVOL
イズモ・カムロギ	アクエリオンEVOL
ゼシカ・ウォン	アクエリオンEVOL
クレア・ドロセラ	アクエリオンEVOL
不動・ZEN	アクエリオンEVOL
サザンカ・ビアンカ	アクエリオンEVOL
カイエン・スズシロ	アクエリオンEVOL
ジン・ムソウ	アクエリオンEVOL
カグラ・デムリ	アクエリオンEVOL
ドナール・ダンテス	アクエリオンEVOL
モロイ・ドレッツァ	アクエリオンEVOL
アンディ・W・ホール	アクエリオンEVOL
エイ・チャン	アクエリオンEVOL
シュレード・エラン	アクエリオンEVOL
ミコノ・スズシロ	アクエリオンEVOL
ユノハ・スルール	アクエリオンEVOL
トワノ・ミカゲ	アクエリオンEVOL
スオミ・コネピ	アクエリオンEVOL
剣嵜総	アクエリオンロゴス
海凪花嵐	アクエリオンロゴス
月銀舞亜	アクエリオンロゴス
粗朶桜子	アクエリオンロゴス
綺声神心音	アクエリオンロゴス
林晋太郎	アクエリオンロゴス
剣嵜荘厳	アクエリオンロゴス
空篠翼人	アクエリオンロゴス
土聞努虫	アクエリオンロゴス
クリムゾン・キングボルト	アクセル・ワールド
パープル・ソーン	アクセル・ワールド
ニッケル・ドール	アクセル・ワールド
荒谷	アクセル・ワールド
塔原直哉	アスタロッテのおもちゃ!
塔原明日葉	アスタロッテのおもちゃ!
佐伯玲士郎	アスラクライン2
アニア・フォルチュナ・ソメシェル・ミク・クラウゼンブルヒ	アスラクライン2
樋口琢磨	アスラクライン2
佐伯玲子	アスラクライン2
嵩月奏	アスラクライン2
黒崎朱浬	アスラクライン2
ガンツ	アソボット戦記五九
ヤズー	アソボット戦記五九
フィオーレ	アソボット戦記五九
タマラ	アソボット戦記五九
魅音	アソボット戦記五九
マーティ	アソボット戦記五九
ミュール	アソボット戦記五九
ガリン	アソボット戦記五九
オキ	アタッカーYOU!
坂下	アタッカーYOU!
浜崎	アタッカーYOU!
トコ	アタックNo.1
早川みどり	アタックNo.1
須賀	アタックNo.1
池崎	アタックNo.1
長谷	アタックNo.1
武市	アタックNo.1
岡	アタックNo.1
八木沢香	アタックNo.1
中原	アタックNo.1
猪俣	アタックNo.1
泉ゆり	アタックNo.1
石本	アタックNo.1
ミレディー	アニメ三銃士
リシュリュー	アニメ三銃士
フィリップ	アニメ三銃士
ロシナンテ	アニメ三銃士
ダルタニャン	アニメ三銃士
アラミス	アニメ三銃士
コンスタンス	アニメ三銃士
ポルトス	アニメ三銃士
鉄仮面	アニメ三銃士
アブラハム	アニメ親子劇場
ヤコブ	アニメ親子劇場
リベカ	アニメ親子劇場
小森	アパッチ野球軍
岩城	アパッチ野球軍
ジャスティス	アフロサムライ
月見璃兎	アブソリュート・デュオ
九十九朔夜	アブソリュート・デュオ
永倉伊万里	アブソリュート・デュオ
穂高みやび	アブソリュート・デュオ
ユリエ・シグトゥーナ	アブソリュート・デュオ
九重透流	アブソリュート・デュオ
虎崎葵	アブソリュート・デュオ
橘巴	アブソリュート・デュオ
リーリス・ブリストル	アブソリュート・デュオ
ムネムネ	アベノ橋魔法☆商店街
門脇将人	アラタカンガタリ〜革神語〜
コトハ	アラタカンガタリ〜革神語〜
ハルナワ	アラタカンガタリ〜革神語〜
日ノ原仍	アラタカンガタリ〜革神語〜
クグラ	アラタカンガタリ〜革神語〜
ヨルナミ	アラタカンガタリ〜革神語〜
アラタ	アラタカンガタリ〜革神語〜
イクシア・ジュン	アラド戦記
ミネルバ	アラド戦記
ロクシー	アラド戦記
ハルセン	アラド戦記
カペンシス	アラド戦記
ラング	アラド戦記
なめくじネコ	アリスSOS
西村	アリスSOS
芦川ゆかり	アリスSOS
杉田ひろみ	アリスSOS
荒井	アリス探偵局
悟空	アリス探偵局
キンヤ	アリス探偵局
キンチャク	アリス探偵局
ダマス	アリス探偵局
アルベロ	アルカナ・ファミリア_-La_storia_della_Arcana_Famiglia-
モレノ	アルカナ・ファミリア_-La_storia_della_Arcana_Famiglia-
シモーネ	アルカナ・ファミリア_-La_storia_della_Arcana_Famiglia-
エルモ	アルカナ・ファミリア_-La_storia_della_Arcana_Famiglia-
リウ・ソーマ	アルジェントソーマ
ユーリ・レオノフ	アルジェントソーマ
ハリエット・バーソロミュー	アルジェントソーマ
ドクター・スチュワート	アルジェントソーマ
ダン・シモンズ	アルジェントソーマ
エステル・デ・ラ・ファーノ	アルスラーン戦記
ジムサ	アルスラーン戦記
ヒルメス	アルスラーン戦記
トゥース	アルスラーン戦記
ジャン・ボダン	アルスラーン戦記
キシュワード	アルスラーン戦記
サーム	アルスラーン戦記
ヴァフリーズ	アルスラーン戦記
アンドラゴラス三世	アルスラーン戦記
シャプール	アルスラーン戦記
フィロタス	アレクサンダー戦記
プラトン	アレクサンダー戦記
ロクサネ	アレクサンダー戦記
パルメニオン	アレクサンダー戦記
クレイトス	アレクサンダー戦記
アンティパトロス	アレクサンダー戦記
アリストテレス	アレクサンダー戦記
アープ	アンデス少年ペペロの冒険
アニータ	アンデス少年ペペロの冒険
MAICO	アンドロイド・アナ_MAICO_2010
カリナ	イクシオン_サーガ_DT
火風紺	イクシオン_サーガ_DT
バリアシオン	イクシオン_サーガ_DT
マリアンデール	イクシオン_サーガ_DT
ヨドガワ・アラン	イクシオン_サーガ_DT
ギュスターヴ	イクシオン_サーガ_DT
アルマフローラ	イクシオン_サーガ_DT
ゲオルギュー	イクシオン_サーガ_DT
エレクパイル・デュカキス	イクシオン_サーガ_DT
黒木美紗	イケてる2人
浦和克典	イケてる2人
佐次京介	イケてる2人
蟻賀瀬涼子	イケてる2人
ラガルート・カルロス	イナズマイレブン
円堂カノン	イナズマイレブン
ガト	イナズマイレブン
鈴目純一	イナズマイレブン
テレス・トルーエ	イナズマイレブン
ニース・ドルフィン	イナズマイレブン
綱海条介	イナズマイレブン
マンティス	イナズマイレブン
エドガー・バルチナス	イナズマイレブン
ウィンディ・ファスタ	イナズマイレブン
五条勝	イナズマイレブン
土方雷電	イナズマイレブン
道端詠	イナズマイレブン
飛鷹征矢	イナズマイレブン
マクスター・ランド	イナズマイレブン
豪炎寺夕香	イナズマイレブン
ジョー・ジョーンズ	イナズマイレブン
ラファエレ・ジェネラーニ	イナズマイレブン
ルシェ	イナズマイレブン
ガルシルド・ベイハン	イナズマイレブン
マック・ロニージョ	イナズマイレブン
ゴーシュ・フレア	イナズマイレブン
二階堂修吾	イナズマイレブン
染岡竜吾	イナズマイレブン
デスタ	イナズマイレブン
ポール・アップルトン	イナズマイレブン
マーク・クルーガー	イナズマイレブン
杉森威	イナズマイレブン
研崎竜一	イナズマイレブン
フォクス	イナズマイレブン
ディラン・キース	イナズマイレブン
ネネル	イナズマイレブン
空野礼文	イナズマイレブン
音村楽也	イナズマイレブン
ジーン・ベイカー	イナズマイレブン
戸田雄一郎	イナズマイレブン
歩星呑一	イナズマイレブン
ウイネル	イナズマイレブン
藤丸啓	イナズマイレブン
宍戸佐吉	イナズマイレブン
平良貞	イナズマイレブン
ザック・アブドゥラ	イナズマイレブン
目金欠流	イナズマイレブン
闇野カゲト	イナズマイレブン
コヨーテ	イナズマイレブン
角馬圭太	イナズマイレブン
壁山塀吾郎	イナズマイレブン
少林寺歩	イナズマイレブン
立向居勇気	イナズマイレブン
エカデル	イナズマイレブン
ロベルト・トーレス	イナズマイレブン
宮坂了	イナズマイレブン
影山零治	イナズマイレブン
バダップ・スリード	イナズマイレブン
浦部リカ	イナズマイレブン
下鶴改	イナズマイレブン
影田巡	イナズマイレブン
豪炎寺真人	イナズマイレブン
ジジ・ブラージ	イナズマイレブン
西垣守	イナズマイレブン
木暮夕弥	イナズマイレブン
財前塔子	イナズマイレブン
チェ・チャンスウ	イナズマイレブン
フィディオ・アルデナ	イナズマイレブン
鉈十三	イナズマイレブン
リュー・スケール	イナズマイレブン
漫画萌	イナズマイレブン
安永英嗣	イナズマイレブン
響木正剛	イナズマイレブン
一之瀬一哉	イナズマイレブン
ピエール・ゴダン	イナズマイレブン
ファルカオ・ダシウバ	イナズマイレブン
洞面秀一郎	イナズマイレブン
幽谷博之	イナズマイレブン
オウル	イナズマイレブン
スキッド・ウー	イナズマイレブン
雷門夏未	イナズマイレブン
吹雪士郎	イナズマイレブン
水前寺馳威太	イナズマイレブン
アーロン・アダムス	イナズマイレブン
地木流灰人	イナズマイレブン
霧隠才次	イナズマイレブン
亀崎河童	イナズマイレブン
松野空介	イナズマイレブン
チョ・ジョンス	イナズマイレブン
豪炎寺修也	イナズマイレブン
土門飛鳥	イナズマイレブン
アンジェロ・ガブリーニ	イナズマイレブン
目金一斗	イナズマイレブン
万丈一道	イナズマイレブン
ロココ・ウルパ	イナズマイレブン
万博美	イナズマイレブン
スコーピオ	イナズマイレブン
デモーニオ・ストラーダ	イナズマイレブン
ジャンルカ・ザナルディ	イナズマイレブン
久遠冬花	イナズマイレブン
アスタロス	イナズマイレブン
小鳥遊忍	イナズマイレブン
豪炎寺勝也	イナズマイレブン
ケーン・サイトー	イナズマイレブン
唐須幸人	イナズマイレブン
綾野勇一	イナズマイレブン
ビヨン・カイル	イナズマイレブン
風魔小平太	イナズマイレブン
鬼瓦源五郎	イナズマイレブン
ショーン・ピアース	イナズマイレブン
風丸一郎太	イナズマイレブン
部灰炎	イナズマイレブン
氷上烈斗	イナズマイレブン
エルフェル	イナズマイレブン
アイエル	イナズマイレブン
マルコ・マセラッティ	イナズマイレブン
ギュエール	イナズマイレブン
ファン・ウミャン	イナズマイレブン
アラクネス	イナズマイレブン
筑紫国光	イナズマイレブン
半田真一	イナズマイレブン
吉良瞳子	イナズマイレブン
フィリップ・オーウェン	イナズマイレブン
如月まこ	イナズマイレブン
ロダン・ガスグス	イナズマイレブンGO
フェイ・ルーン	イナズマイレブンGO
ローコ	イナズマイレブンGO
チェル	イナズマイレブンGO
ミド	イナズマイレブンGO
不知火影二	イナズマイレブンGO
ガンダレス・バラン	イナズマイレブンGO
樹田木蓮	イナズマイレブンGO
鬼道有人	イナズマイレブンGO
合川賢	イナズマイレブンGO
日向理恩	イナズマイレブンGO
カゼルマ・ウォーグ	イナズマイレブンGO
ネオル・ロッツ	イナズマイレブンGO
影浦透司	イナズマイレブンGO
エイナム	イナズマイレブンGO
クラーク・ワンダバット	イナズマイレブンGO
セレン・メルヴィル	イナズマイレブンGO
チュルカ・ポッタ	イナズマイレブンGO
ヴァンフェニー・ヴァンプ	イナズマイレブンGO
ザノウ	イナズマイレブンGO
音無春奈	イナズマイレブンGO
エーギル・セファイド	イナズマイレブンGO
安藤恒之	イナズマイレブンGO
真帆路正	イナズマイレブンGO
カシム・バドル	イナズマイレブンGO
兵頭司	イナズマイレブンGO
蛇野巻人	イナズマイレブンGO
デイモス・レプトン	イナズマイレブンGO
円堂守	イナズマイレブンGO
白咲克也	イナズマイレブンGO
聖城将護	イナズマイレブンGO
ガンマ	イナズマイレブンGO
黒裂真命	イナズマイレブンGO
市正	イナズマイレブンGO
冬海卓	イナズマイレブンGO
清水柳人	イナズマイレブンGO
跳沢真波	イナズマイレブンGO
ルード	イナズマイレブンGO
河宮幸多	イナズマイレブンGO
木野秋	イナズマイレブンGO
皆帆和人	イナズマイレブンGO
前林香林	イナズマイレブンGO
江島一八	イナズマイレブンGO
浜野海士	イナズマイレブンGO
恋崎伊雄	イナズマイレブンGO
佐久間次郎	イナズマイレブンGO
山菜茜	イナズマイレブンGO
マッチョス	イナズマイレブンGO
帆田光洋	イナズマイレブンGO
真名部陣一郎	イナズマイレブンGO
関羽	イナズマイレブンGO
不知火幻一	イナズマイレブンGO
氷里樹	イナズマイレブンGO
チューリ	イナズマイレブンGO
ウォード	イナズマイレブンGO
諸葛孔明	イナズマイレブンGO
柴田勝時	イナズマイレブンGO
井吹宗正	イナズマイレブンGO
九坂隆二	イナズマイレブンGO
ロータス	イナズマイレブンGO
クオース	イナズマイレブンGO
ナム・ドヒョン	イナズマイレブンGO
ジニアス	イナズマイレブンGO
浪川蓮助	イナズマイレブンGO
御門春馬	イナズマイレブンGO
ネイラ	イナズマイレブンGO
影山輝	イナズマイレブンGO
ララヤ・オビエス	イナズマイレブンGO
雅野麗一	イナズマイレブンGO
金山郷造	イナズマイレブンGO
牙山道三	イナズマイレブンGO
クオル	イナズマイレブンGO
レイザ	イナズマイレブンGO
征木帝矢	イナズマイレブンGO
青銅弾	イナズマイレブンGO
後藤結界	イナズマイレブンGO
真住火朗志	イナズマイレブンGO
森村好葉	イナズマイレブンGO
カトラ・ペイジ	イナズマイレブンGO
瀬戸水鳥	イナズマイレブンGO
稲葉大安	イナズマイレブンGO
リュゲル・バラン	イナズマイレブンGO
瞬木隼人	イナズマイレブンGO
天城大地	イナズマイレブンGO
磯崎研磨	イナズマイレブンGO
深淵断道	イナズマイレブンGO
アスレイ・ルーン	イナズマイレブンGO
リ・チュンユン	イナズマイレブンGO
甲斐信武	イナズマイレブンGO
近藤啓士	イナズマイレブンGO
千宮路大悟	イナズマイレブンGO
松風天馬	イナズマイレブンGO
龍崎皇児	イナズマイレブンGO
レイ・ルク	イナズマイレブンGO
雪村豹牙	イナズマイレブンGO
鉄角真	イナズマイレブンGO
スタッグ・クワッタ	イナズマイレブンGO
箱野随一	イナズマイレブンGO
ビオラ	イナズマイレブンGO
久遠道也	イナズマイレブンGO
シュウの妹	イナズマイレブンGO
潮賢次郎	イナズマイレブンGO
読矢聡	イナズマイレブンGO
神山豪之伸	イナズマイレブンGO
三国太一	イナズマイレブンGO
ファダム	イナズマイレブンGO
ヴァルハ・ポロポ	イナズマイレブンGO
亜風炉照美	イナズマイレブンGO
アルベガ・ゴードン	イナズマイレブンGO
水川みのり	イナズマイレブンGO
バルガ・ザックス	イナズマイレブンGO
笹山滝	イナズマイレブンGO
宇都宮虎丸	イナズマイレブンGO
ザナーク・アバロニク	イナズマイレブンGO
ストロウ	イナズマイレブンGO
錦龍馬	イナズマイレブンGO
青山俊介	イナズマイレブンGO
雨宮太陽	イナズマイレブンGO
真狩銀次郎	イナズマイレブンGO
オルカ	イナズマイレブンGO
矢嶋陽介	イナズマイレブンGO
デスピナ・ラクス	イナズマイレブンGO
牧里水樹	イナズマイレブンGO
竹中半蔵	イナズマイレブンGO
ガルシャア・ウルフェイン	イナズマイレブンGO
狩屋マサキ	イナズマイレブンGO
一文字斬斗	イナズマイレブンGO
虚木実美	イナズマイレブンGO
冴渡優一郎	イナズマイレブンGO
海図航一郎	イナズマイレブンGO
イシガシ・ゴーラム	イナズマイレブンGO
湾田七雄人	イナズマイレブンGO
吉良周吾	イナズマイレブンGO
真田六郎	イナズマイレブンGO
香坂幸恵	イナズマイレブンGO
三波十次	イナズマイレブンGO
向坂悟	イナズマイレブンGO
グラ・フォム	イナズマイレブンGO
隼総英聖	イナズマイレブンGO
滝総介	イナズマイレブンGO
久雲仁太	イナズマイレブンGO
ロデオ	イナズマイレブンGO
仁悟	イナズマイレブンGO
逆崎無限	イナズマイレブンGO
タムガン・ジャー	イナズマイレブンGO
ジーニー	イナズマイレブンGO
速水鶴正	イナズマイレブンGO
オクタ・パースン	イナズマイレブンGO
ユーリ・アヴェリン	イナズマイレブンGO
倉間典人	イナズマイレブンGO
神童拓人	イナズマイレブンGO
ブル・レクス	イナズマイレブンGO
西園信助	イナズマイレブンGO
和泉奏秋	イナズマイレブンGO
ビットウェイ・オズロック	イナズマイレブンGO
銅原帝人	イナズマイレブンGO
グゥミ	イナズマイレブンGO
星降香宮夜	イナズマイレブンGO
喜峰岬	イナズマイレブンGO
喜多一番	イナズマイレブンGO
南沢篤志	イナズマイレブンGO
サージェス・ルーグ	イナズマイレブンGO
メダム	イナズマイレブンGO
イシドシュウジ	イナズマイレブンGO
根淵海友	イナズマイレブンGO
一乃七助	イナズマイレブンGO
木瀧常緒	イナズマイレブンGO
野咲さくら	イナズマイレブンGO
神田里子	イナズマイレブンGO
リン・クール	イナズマイレブンGO
霧野蘭丸	イナズマイレブンGO
滝快彦	イナズマイレブンGO
石岩次郎	イナズマイレブンGO
ホス	イナズマイレブンGO
菜花黄名子	イナズマイレブンGO
ラウ・セム	イナズマイレブンGO
ルスラン・カシモフ	イナズマイレブンGO
ドミトリー・ソビロフ	イナズマイレブンGO
ティス・カーマ	イナズマイレブンGO
張飛	イナズマイレブンGO
五味清栄	イナズマイレブンGO
船木宏正	イナズマイレブンGO
伍代慎吾	イナズマイレブンGO
市川座名九郎	イナズマイレブンGO
貴志部大河	イナズマイレブンGO
木屋功治	イナズマイレブンGO
小坂元成	イナズマイレブンGO
新田ミル	イナズマイレブンGO
シンジャミ	イナズマイレブンGO
西野空宵一	イナズマイレブンGO
登戸沙那	イノセント・ヴィーナス
ごら	イノセント・ヴィーナス
剣吾	イノセント・ヴィーナス
左反衣	ウィザード・バリスターズ_弁魔士セシル
穂樽夏菜	ウィザード・バリスターズ_弁魔士セシル
工白志吹	ウィザード・バリスターズ_弁魔士セシル
天刀もよ	ウィザード・バリスターズ_弁魔士セシル
柄工双静夢	ウィザード・バリスターズ_弁魔士セシル
蜂谷ミツヒサ	ウィザード・バリスターズ_弁魔士セシル
氷尾凍子	ウィッチクラフトワークス
飾鈴	ウィッチクラフトワークス
多華宮小町	ウィッチクラフトワークス
昏峰あとり	ウィッチクラフトワークス
火々里かざね	ウィッチクラフトワークス
目野輪冥	ウィッチクラフトワークス
多華宮霞	ウィッチクラフトワークス
深影恭一郎	ウィッチクラフトワークス
桂虎徹	ウィッチクラフトワークス
宇津木環那	ウィッチクラフトワークス
倉石たんぽぽ	ウィッチクラフトワークス
乙女橘りのん	ウィッチクラフトワークス
クロノワールシュヴァルツ・シックス	ウィッチクラフトワークス
深影棗	ウィッチクラフトワークス
シェリー	ウエルベールの物語_〜Sisters_of_Wellber〜
ニナ・サクレイル	ウルトラマニアック
ルチャマスター	エアマスター
彰子	エアマスター
北枝金次郎	エアマスター
屋敷俊	エアマスター
崎山香織	エアマスター
長戸	エアマスター
小西良徳	エアマスター
花井	エアマスター
河原	エアマスター
武月雄	エアマスター
サンパギータ・カイ	エアマスター
戸叶	エアマスター
ファルコ	エア・ギア
キリク	エア・ギア
坂東ミツル	エア・ギア
カズ	エア・ギア
中山弥生	エア・ギア
野山野林檎	エア・ギア
武内空	エア・ギア
シムカ	エア・ギア
安達絵美理	エア・ギア
ポチョムキン	エア・ギア
エウレカ	エウレカセブンAO
ハン・ジュノ	エウレカセブンAO
エレナ・ピープルズ	エウレカセブンAO
クロエ・マキャフリイ	エウレカセブンAO
ナカムラ	エウレカセブンAO
マギー・クァン	エウレカセブンAO
レベッカ・ハルストレム	エウレカセブンAO
フレア・ブラン	エウレカセブンAO
レントン・サーストン	エウレカセブンAO
トゥルース	エウレカセブンAO
クリストフ・ブラン	エウレカセブンAO
イビチャ・タノヴィッチ	エウレカセブンAO
メイヴ・マキャフリイ	エウレカセブンAO
コンポコ	エスパー魔美
佐倉十朗	エスパー魔美
ゴルドー	エデンズボゥイ
エリシス	エデンズボゥイ
シーダ	エデンズボゥイ
島亮介	エリアの騎士
沢村優司	エリアの騎士
紅林礼生	エリアの騎士
織田涼真	エリアの騎士
Roberto	エリアの騎士
天童次英	エリアの騎士
兵藤誠	エリアの騎士
天童一英	エリアの騎士
五島	エリアの騎士
セルシア・マリクレール	エルフを狩るモノたち
ピチちゃん	エルフを狩るモノたち
アネット	エルフを狩るモノたち
小宮山愛理	エルフを狩るモノたち
井上律子	エルフを狩るモノたち
ビザール	エルフを狩るモノたち
坂東	エルフェンリート
大森	エルフェンリート
白河	エルフェンリート
マリコ	エルフェンリート
カナエ	エルフェンリート
荒川	エルフェンリート
コウタ	エルフェンリート
L・A	エル・カザド
イヴ	エレメンタル_ジェレイド
シャルロ	エレメンタル_ジェレイド
槇村香	エンジェル・ハート
劉信宏	エンジェル・ハート
ファルコン	エンジェル・ハート
香瑩	エンジェル・ハート
竜宮乙姫	オオカミさんと七人の仲間たち
熊田	オオカミさんと七人の仲間たち
鶴ヶ谷おつう	オオカミさんと七人の仲間たち
桐木リスト	オオカミさんと七人の仲間たち
犬塚	オオカミさんと七人の仲間たち
地蔵亜美	オオカミさんと七人の仲間たち
桐木アリス	オオカミさんと七人の仲間たち
吉備津桃子	オオカミさんと七人の仲間たち
猫宮三郎	オオカミさんと七人の仲間たち
森野亮士	オオカミさんと七人の仲間たち
浦島太郎	オオカミさんと七人の仲間たち
佐田恭也	オオカミ少女と黒王子
三田亜由美	オオカミ少女と黒王子
日下部憂	オオカミ少女と黒王子
大原正太	オバケのQ太郎
小池さん	オバケのQ太郎
神成さん	オバケのQ太郎
大原伸一	オバケのQ太郎
若狭	オレん家のフロ事情
鷹巣	オレん家のフロ事情
真木	オレん家のフロ事情
魔王ムウス	オレカバトル
内木デー太	オレカバトル
ひょーひょー	カイバ
クロニコ	カイバ
メイファ	カウボーイビバップ
ビシャス	カウボーイビバップ
コフィ	カウボーイビバップ
ヴィンセント・ボラージュ	カウボーイビバップ
ジュリアス	カウボーイビバップ
霞蘭子	カスミン
冬田雪乃	カスミン
ドグウちゃん	カスミン
霞桜女	カスミン
帽子男	カスミン
霞仙太郎	カスミン
霧野霧彦	カスミン
ポトポット	カスミン
榊原かえで	カスミン
阿部ユリ	カスミン
レイラ・ハミルトン	カレイドスター
ミア・ギエム	カレイドスター
イアン・ソープ	カレイドスター
ケン・ロビンス	カレイドスター
ミュート	カレイドスター
Dio	カレイドスター
ジョナサン	カレイドスター
美樹	カレイドスター
パンドラ	カンピオーネ!_〜まつろわぬ神々と神殺しの魔王〜
ルクレチア・ゾラ	カンピオーネ!_〜まつろわぬ神々と神殺しの魔王〜
アリアンナ・ハヤマ・アリアルディ	カンピオーネ!_〜まつろわぬ神々と神殺しの魔王〜
メティス	カンピオーネ!_〜まつろわぬ神々と神殺しの魔王〜
草薙静花	カンピオーネ!_〜まつろわぬ神々と神殺しの魔王〜
月城雪兎	カードキャプターさくら
大道寺知世	カードキャプターさくら
観月歌帆	カードキャプターさくら
クロウ・リード	カードキャプターさくら
山崎貴史	カードキャプターさくら
柊沢エリオル	カードキャプターさくら
三原千春	カードキャプターさくら
李小狼	カードキャプターさくら
松本真樹	カードキャプターさくら
佐々木利佳	カードキャプターさくら
木之本撫子	カードキャプターさくら
ミラー	カードキャプターさくら
スピネル・サン	カードキャプターさくら
諏訪部イツキ	カードファイト!!_ヴァンガード
岸田オサム	カードファイト!!_ヴァンガード
DAIGO	カードファイト!!_ヴァンガード
臼井ガイ	カードファイト!!_ヴァンガード
櫂トシキ	カードファイト!!_ヴァンガード
先導エミ	カードファイト!!_ヴァンガード
那嘉神エル	カードファイト!!_ヴァンガード
中津川ヒロシ	カードファイト!!_ヴァンガード
臼井ユリ	カードファイト!!_ヴァンガード
明日川タイヨウ	カードファイト!!_ヴァンガード
長代マキ	カードファイト!!_ヴァンガード
オリビエ・ガイヤール	カードファイト!!_ヴァンガード
井崎ユウタ	カードファイト!!_ヴァンガード
鳴海アサカ	カードファイト!!_ヴァンガード
ファジル・アリ	カードファイト!!_ヴァンガード
三和タイシ	カードファイト!!_ヴァンガード
MCミヤ	カードファイト!!_ヴァンガード
モレス・ペニーワース	カードファイト!!_ヴァンガード
右野レイジ	カードファイト!!_ヴァンガード
美童キリヤ	カードファイト!!_ヴァンガード
矢作キョウ	カードファイト!!_ヴァンガード
マーク・ホワイティング	カードファイト!!_ヴァンガード
クリストファー・ロウ	カードファイト!!_ヴァンガード
フィリップ・ネーヴ	カードファイト!!_ヴァンガード
ラティ・カーティ	カードファイト!!_ヴァンガード
蝶野アム	カードファイト!!_ヴァンガード
安城マモル	カードファイト!!_ヴァンガード
弥富サヤ	カードファイト!!_ヴァンガード
東雲ショウマ	カードファイト!!_ヴァンガード
多度ツネト	カードファイト!!_ヴァンガード
栄生アキラ	カードファイト!!_ヴァンガード
新導クロノ	カードファイト!!_ヴァンガード
内藤タテワキ	カードファイト!!_ヴァンガード
六月ジュン	カードファイト!!_ヴァンガード
岡崎クミ	カードファイト!!_ヴァンガード
石田ナオキ	カードファイト!!_ヴァンガード
新城テツ	カードファイト!!_ヴァンガード
左賀エイジ	カードファイト!!_ヴァンガード
羽島リン	カードファイト!!_ヴァンガード
シャーリーン・チェン	カードファイト!!_ヴァンガード
戸倉ミサキ	カードファイト!!_ヴァンガード
明神リューズ	カードファイト!!_ヴァンガード
新導ライブ	カードファイト!!_ヴァンガード
枇杷島ジョー	カードファイト!!_ヴァンガード
四会アカリ	カードファイト!!_ヴァンガード
神崎ユウイチロウ	カードファイト!!_ヴァンガード
リザード	カードファイト!!_ヴァンガード
美好ヒロミ	カードファイト!!_ヴァンガード
綺場シオン	カードファイト!!_ヴァンガード
馬場タケル	カードファイト!!_ヴァンガード
光定ケンジ	カードファイト!!_ヴァンガード
伊吹コウジ	カードファイト!!_ヴァンガード
江西サトル	カードファイト!!_ヴァンガード
新導ミクル	カードファイト!!_ヴァンガード
黒沢ヒカル	カードファイト!!_ヴァンガード
リー・シェンロン	カードファイト!!_ヴァンガード
雀ヶ森レン	カードファイト!!_ヴァンガード
ジリアン・チェン	カードファイト!!_ヴァンガード
美浜アユム	カードファイト!!_ヴァンガード
弓月ルーナ	カードファイト!!_ヴァンガード
ハイメ・アルカラス	カードファイト!!_ヴァンガード
先導シズカ	カードファイト!!_ヴァンガード
ラウル・セラ	カードファイト!!_ヴァンガード
小茂井シンゴ	カードファイト!!_ヴァンガード
堂島	カードファイト!!_ヴァンガード
葛木カムイ	カードファイト!!_ヴァンガード
美南ハルミ	カードファイト!!_ヴァンガード
安城トコハ	カードファイト!!_ヴァンガード
ダイモン	ガイキング_LEGEND_OF_DAIKU-MARYU
ルル・アージェス	ガイキング_LEGEND_OF_DAIKU-MARYU
プロイスト	ガイキング_LEGEND_OF_DAIKU-MARYU
ケイン	ガイキング_LEGEND_OF_DAIKU-MARYU
ツワブキ・ダイヤ	ガイキング_LEGEND_OF_DAIKU-MARYU
フランクリン	ガイキング_LEGEND_OF_DAIKU-MARYU
サコン	ガイキング_LEGEND_OF_DAIKU-MARYU
サイファ	ガイストクラッシャー
シレン・クォーツハート	ガイストクラッシャー
真銅クラマ	ガイストクラッシャー
新田ケン	ガイストクラッシャー
亜藤ジン太	ガイストクラッシャー
白銀ゴウカ	ガイストクラッシャー
黒曜イズナ	ガイストクラッシャー
ジプ	ガイストクラッシャー
白銀ひのこ	ガイストクラッシャー
白銀リン	ガイストクラッシャー
桜さんご	ガイストクラッシャー
灰野灰二郎	ガイストクラッシャー
知丹崎優	ガイストクラッシャー
ドール	ガサラキ
美晴	ガサラキ
ウェイン	ガサラキ
李	ガサラキ
柴崎	ガサラキ
西田啓	ガサラキ
空知	ガサラキ
渡辺競	ガサラキ
桑島	ガサラキ
ミハル	ガサラキ
源頼光	ガサラキ
三栖立つばさ	ガッチャマン_クラウズ
O・D	ガッチャマン_クラウズ
ベルク・カッツェ	ガッチャマン_クラウズ
枇々木丈	ガッチャマン_クラウズ
ゲルサドラ	ガッチャマン_クラウズ
橘清音	ガッチャマン_クラウズ
J・J・ロビンソン	ガッチャマン_クラウズ
国分阿蘭	ガッチャマン_クラウズ
パイマン	ガッチャマン_クラウズ
爾乃美家累	ガッチャマン_クラウズ
桜田	ガッ活!
佐伯	ガッ活!
長峰	ガッ活!
塚原	ガッ活!
保倉	ガッ活!
木元	ガッ活!
洋一	ガッ活!
安倍	ガッ活!
鷹宮紫織	ガラスの仮面ですが
北島マヤ	ガラスの仮面ですが
速水真澄	ガラスの仮面ですが
姫川亜弓	ガラスの仮面ですが
月影千草	ガラスの仮面ですが
ヘクター	ガラスの艦隊
マグヌス	ガラスの艦隊
アイメル	ガラスの艦隊
カーズ	ガラスの艦隊
ロベルト・マテラッツィ	ガリレイドンナ
葉月・フェラーリ	ガリレイドンナ
アンナ・ヘンドリックス	ガリレイドンナ
シシーニョ	ガリレイドンナ
神月・フェラーリ	ガリレイドンナ
カルメン99	ガン×ソード
ウィリアム・ウィル・ウー	ガン×ソード
九頭文治	ガングレイヴ
浅葱ミカ	ガングレイヴ
ハリー・マクドゥエル	ガングレイヴ
ξ988	ガンスリンガー_ストラトス
水潟九美	ガンスリンガー_ストラトス
風澄徹	ガンスリンガー_ストラトス
ジョナサン・サイズモア	ガンスリンガー_ストラトス
片桐鏡磨	ガンスリンガー_ストラトス
篠生茉莉	ガンスリンガー_ストラトス
草陰稜	ガンスリンガー_ストラトス
リューシャ	ガンスリンガー_ストラトス
羅漢堂旭	ガンスリンガー_ストラトス
綾小路咲良	ガンスリンガー_ストラトス
片桐鏡華	ガンスリンガー_ストラトス
天堂寺セイラ	ガンスリンガー_ストラトス
オルガ・ジェンテイン	ガンスリンガー_ストラトス
ウィルミット・ゼナム	ガンダム_Gのレコンギスタ
ノウトゥ・ドレット	ガンダム_Gのレコンギスタ
カーヒル・セイント	ガンダム_Gのレコンギスタ
アダム・スミス	ガンダム_Gのレコンギスタ
ミック・ジャック	ガンダム_Gのレコンギスタ
クン・スーン	ガンダム_Gのレコンギスタ
デレンセン・サマター	ガンダム_Gのレコンギスタ
マッシュナー・ヒューム	ガンダム_Gのレコンギスタ
バララ・ペオール	ガンダム_Gのレコンギスタ
リンゴ・ロン・ジャマノッタ	ガンダム_Gのレコンギスタ
ケルベス・ヨー	ガンダム_Gのレコンギスタ
ノレド・ナグ	ガンダム_Gのレコンギスタ
ラ・グー	ガンダム_Gのレコンギスタ
マニィ・アンバサダ	ガンダム_Gのレコンギスタ
ドニエル・トス	ガンダム_Gのレコンギスタ
チッカラ・デュアル	ガンダム_Gのレコンギスタ
キア・ムベッキ	ガンダム_Gのレコンギスタ
アイーダ・スルガン	ガンダム_Gのレコンギスタ
オリバー	ガンダム_Gのレコンギスタ
グシオン・スルガン	ガンダム_Gのレコンギスタ
ロックパイ・ゲティ	ガンダム_Gのレコンギスタ
ルイン・リー	ガンダム_Gのレコンギスタ
フラウ・ボゥ	ガンダムさん
キッカ・キタモト	ガンダムさん
ハヤト・コバヤシ	ガンダムさん
フラナガン	ガンダムさん
アムロ・レイ	ガンダムさん
ガルマ・ザビ	ガンダムさん
ウッディ・マルデン	ガンダムさん
デギン・ソド・ザビ	ガンダムさん
セイラ・マス	ガンダムさん
シャア・アズナブル	ガンダムさん
ララァ・スン	ガンダムさん
カイ・シデン	ガンダムさん
リカルド・フェリーニ	ガンダムビルドファイターズ
マシタ会長	ガンダムビルドファイターズ
辰造	ガンダムビルドファイターズ
珍庵	ガンダムビルドファイターズ
ミヤガ・ダイキ	ガンダムビルドファイターズ
サザキ・タテオ	ガンダムビルドファイターズ
レディ・カワグチ	ガンダムビルドファイターズ
オカモト・ユキオ	ガンダムビルドファイターズ
ナイン・バルト	ガンダムビルドファイターズ
ジュリアン・マッケンジー	ガンダムビルドファイターズ
ヤジマ・キャロライン	ガンダムビルドファイターズ
アドウ・サガ	ガンダムビルドファイターズ
ベイカー	ガンダムビルドファイターズ
ライナー・チョマー	ガンダムビルドファイターズ
ヒビキ	ガンダムビルドファイターズ
シノダ・エリ	ガンダムビルドファイターズ
ホシノ・マリカ	ガンダムビルドファイターズ
グレコ・ローガン	ガンダムビルドファイターズ
ルーカス・ネメシス	ガンダムビルドファイターズ
スドウ・シュンスケ	ガンダムビルドファイターズ
スガ・アキラ	ガンダムビルドファイターズ
アラン・アダムス	ガンダムビルドファイターズ
イオリ・タケシ	ガンダムビルドファイターズ
シグレ・マヒル	ガンダムビルドファイターズ
イサカ・ヒデオ	ガンダムビルドファイターズ
イノセ・ジュンヤ	ガンダムビルドファイターズ
コウサカ・チナ	ガンダムビルドファイターズ
レナート兄弟	ガンダムビルドファイターズ
キジマ・シア	ガンダムビルドファイターズ
カリマ・ケイ	ガンダムビルドファイターズ
ラルさん	ガンダムビルドファイターズ
サザキ・ススム	ガンダムビルドファイターズ
カミキ・ミライ	ガンダムビルドファイターズ
コウサカ・ユウマ	ガンダムビルドファイターズ
サノ・ケイコ	ガンダムビルドファイターズ
ニルス・ニールセン	ガンダムビルドファイターズ
ヤス・メグタ	ガンダムビルドファイターズ
サザキ・カオルコ	ガンダムビルドファイターズ
キジマ・ウィルフリッド	ガンダムビルドファイターズ
カミキ・セカイ	ガンダムビルドファイターズ
アイラ・ユルキアイネン	ガンダムビルドファイターズ
ヤサカ・マオ	ガンダムビルドファイターズ
ゴンダ・モンタ	ガンダムビルドファイターズ
コデラ・マサミ	ガンダムビルドファイターズ
アリーア・フォン・レイジ・アスナ	ガンダムビルドファイターズ
サトウ・ハルト	ガンダムビルドファイターズ
サカシタ・ヨミ	ガンダムビルドファイターズ
イズナ・シモン	ガンダムビルドファイターズ
ルワン・ダラーラ	ガンダムビルドファイターズ
ユウキ・タツヤ	ガンダムビルドファイターズ
イオリ・リン子	ガンダムビルドファイターズ
ホシノ・フミナ	ガンダムビルドファイターズ
ジョン・エアーズ・マッケンジー	ガンダムビルドファイターズ
TAKU	ガンダムビルドファイターズ
イシバシ・ダイゴ	ガンダムビルドファイターズ
イズナ・マモル	ガンダムビルドファイターズ
ボーボ	ガンバの冒険
一郎	ガンバの冒険
ナギサ	ガンバの冒険
順太	ガンバの冒険
シジン	ガンバの冒険
忠太	ガンバの冒険
内田稔	ガンバリスト!駿
田所	ガンバリスト!駿
来須銀河	ガンパレード・マーチ_〜新たなる行軍歌〜
遠坂圭吾	ガンパレード・マーチ_〜新たなる行軍歌〜
石津萌	ガンパレード・マーチ_〜新たなる行軍歌〜
東原ののみ	ガンパレード・マーチ_〜新たなる行軍歌〜
坂上久臣	ガンパレード・マーチ_〜新たなる行軍歌〜
滝川陽平	ガンパレード・マーチ_〜新たなる行軍歌〜
善行忠孝	ガンパレード・マーチ_〜新たなる行軍歌〜
森精華	ガンパレード・マーチ_〜新たなる行軍歌〜
加藤祭	ガンパレード・マーチ_〜新たなる行軍歌〜
中村光弘	ガンパレード・マーチ_〜新たなる行軍歌〜
岩田裕	ガンパレード・マーチ_〜新たなる行軍歌〜
新井木勇美	ガンパレード・マーチ_〜新たなる行軍歌〜
芝村舞	ガンパレード・マーチ_〜新たなる行軍歌〜
田辺真紀	ガンパレード・マーチ_〜新たなる行軍歌〜
田代香織	ガンパレード・マーチ_〜新たなる行軍歌〜
原素子	ガンパレード・マーチ_〜新たなる行軍歌〜
芙来田伊吹	ガールフレンド（仮）
島田泉	ガールフレンド（仮）
ミス・モノクローム	ガールフレンド（仮）
ヴァリレイ	キスダム_-ENGAGE_planet-
真崎	キスダム_-ENGAGE_planet-
流姫那由乃	キスダム_-ENGAGE_planet-
玲	キスダム_-ENGAGE_planet-
桜井妙子	キテレツ大百科
平吉	キテレツ大百科
ボルトン	キャシャーン_Sins
ソフィータ	キャシャーン_Sins
バラシン	キャシャーン_Sins
ルナ	キャシャーン_Sins
レダ	キャシャーン_Sins
ディオ	キャシャーン_Sins
ジャニス	キャシャーン_Sins
リューズ	キャシャーン_Sins
オージ	キャシャーン_Sins
プルルン	キャッ党忍伝てやんでえ
ヤッ太郎	キャッ党忍伝てやんでえ
スカシー	キャッ党忍伝てやんでえ
夜祭ツバキ	キャプテン・アース
嵐エイジ	キャプテン・アース
ミア	キャプテン・アース
サンダー	キャプテン・アース
ピッツ	キャプテン・アース
立花和夫	キャプテン翼
エル・シド・ピエール	キャプテン翼
日向小次郎	キャプテン翼
次藤洋	キャプテン翼
立花政夫	キャプテン翼
井沢守	キャプテン翼
カール・ハインツ・シュナイダー	キャプテン翼
トラム	キャプテン翼
葵新伍	キャプテン翼
メンデス	キャプテン翼
来生哲兵	キャプテン翼
パウロ	キャプテン翼
カルロス・サンターナ	キャプテン翼
カリメロ	キャプテン翼
ステファン・レヴィン	キャプテン翼
岸田猛	キャプテン翼
小田和正	キャプテン翼
岬太郎	キャプテン翼
早田誠	キャプテン翼
ロベルト本郷	キャプテン翼
森崎有三	キャプテン翼
ファン・ディアス	キャプテン翼
青葉弥生	キャプテン翼
浦辺反次	キャプテン翼
日向勝	キャプテン翼
沢田タケシ	キャプテン翼
松山光	キャプテン翼
滝一	キャプテン翼
新田瞬	キャプテン翼
ジノ・ヘルナンデス	キャプテン翼
アンソニー・ブラウン	キャンディ・キャンディ
アルバート	キャンディ・キャンディ
蔵見虎泰	キューティクル探偵因幡
因幡遥	キューティクル探偵因幡
野崎圭	キューティクル探偵因幡
ステラ	キューティクル探偵因幡
因幡洋	キューティクル探偵因幡
剣持和臣	キューティクル探偵因幡
佐々木優太	キューティクル探偵因幡
荻野若葉	キューティクル探偵因幡
ゴールドディガー	キューティーハニー
ゆりえ	キューティーハニー
葉月聖羅	キューティーハニー
夏子	キューティーハニー
セイレーン	キューティーハニー
没キャラ	キルミーベイベー
青龍三郎	キルラキル
犬牟田宝火	キルラキル
黄長瀬紬	キルラキル
伊織糸郎	キルラキル
蟒草田男	キルラキル
鳳凰丸礼	キルラキル
轟輌輔	キルラキル
揃三蔵	キルラキル
猿投山渦	キルラキル
大林九二	キルラキル
今川	キルラキル
朱雀二郎	キルラキル
袋田隆治	キルラキル
函館臣子	キルラキル
針目縫	キルラキル
満艦飾好代	キルラキル
白虎四郎	キルラキル
蛇崩乃音	キルラキル
蟇郡苛	キルラキル
鬼龍院皐月	キルラキル
満艦飾又郎	キルラキル
満艦飾マコ	キルラキル
美木杉愛九郎	キルラキル
矢車草之助	キルラキル
鬼龍院羅暁	キルラキル
宝多金男	キルラキル
大暮麻衣子	キルラキル
玄武太郎	キルラキル
レニー・ハート	キン肉マンII世
友和	キン肉マンII世
キン骨マン	キン肉マンII世
ジャクリーン・マッスル	キン肉マンII世
フォーク・ザ・ジャイアント	キン肉マンII世
恵子	キン肉マンII世
キン肉アタル	キン肉マンII世
アレキサンドリア・ミート	キン肉マンII世
キン肉スグル	キン肉マンII世
二階堂凛子	キン肉マンII世
ハラボテ・マッスル	キン肉マンII世
ボーン・コールド	キン肉マンII世
キン肉真弓	キン肉マンII世
二階堂マリ	キン肉マンII世
ラモス	ギャラリーフェイク
高倉	ギャラリーフェイク
魂館颯太	ギルティクラウン
寒川谷尋	ギルティクラウン
倉知	ギルティクラウン
四分儀	ギルティクラウン
楪いのり	ギルティクラウン
城戸研二	ギルティクラウン
恙神涯	ギルティクラウン
草間花音	ギルティクラウン
ダリル・ヤン	ギルティクラウン
寒川潤	ギルティクラウン
校条祭	ギルティクラウン
桜満春夏	ギルティクラウン
月島アルゴ	ギルティクラウン
スクルージ	ギルティクラウン
桜満真名	ギルティクラウン
武器屋カトレア	クイーンズブレイド_流浪の戦士
ドゴール	クイーンズブレイド_流浪の戦士
叛乱の騎士姫アンネロッテ	クイーンズブレイド_流浪の戦士
歴戦の傭兵エキドナ	クイーンズブレイド_流浪の戦士
魔装剣姫カグヤ	クイーンズブレイド_流浪の戦士
不思議の国の闇使いアリシア	クイーンズブレイド_流浪の戦士
赤頭巾の魔狩人ザラ	クイーンズブレイド_流浪の戦士
異端審問官シギィ	クイーンズブレイド_流浪の戦士
牙の暗殺者イルマ	クイーンズブレイド_流浪の戦士
セトラ	クイーンズブレイド_流浪の戦士
戦闘教官アレイン	クイーンズブレイド_流浪の戦士
冥土へ誘うものアイリ	クイーンズブレイド_流浪の戦士
人魚姫ティーナ	クイーンズブレイド_流浪の戦士
しあわせウサギ	クマのプー太郎
MU	クラッシュギアNitro
キリエ	クリスタル_ブレイズ
ローレンス	クリスタル_ブレイズ
マナミ	クリスタル_ブレイズ
ヨブ	クリスタル_ブレイズ
川口	クレヨンしんちゃん
ふかづめ竜子	クレヨンしんちゃん
鳩ヶ谷	クレヨンしんちゃん
風間トオル	クレヨンしんちゃん
姫宮	クレヨンしんちゃん
染谷	クレヨンしんちゃん
四郎	クレヨンしんちゃん
野原みさえ	クレヨンしんちゃん
魚の目お銀	クレヨンしんちゃん
ピカソ小川	クレヨンしんちゃん
小山むさえ	クレヨンしんちゃん
鳩ヶ谷ミッチー	クレヨンしんちゃん
セイン	クレヨンしんちゃん
佐藤マサオ	クレヨンしんちゃん
神田鳥忍	クレヨンしんちゃん
多田	クレヨンしんちゃん
桜ミミ子	クレヨンしんちゃん
風間みね子	クレヨンしんちゃん
小山よし治	クレヨンしんちゃん
もえP	クレヨンしんちゃん
高倉文太	クレヨンしんちゃん
太田	クレヨンしんちゃん
まつざか梅	クレヨンしんちゃん
野原ひろし	クレヨンしんちゃん
たけし	クレヨンしんちゃん
北本	クレヨンしんちゃん
ボーちゃん	クレヨンしんちゃん
小山まさえ	クレヨンしんちゃん
ぶりぶりざえもん	クレヨンしんちゃん
酢乙女あい	クレヨンしんちゃん
野原銀の介	クレヨンしんちゃん
アクション仮面	クレヨンしんちゃん
胃屋良支又吉	クレヨンしんちゃん
桜田ネネ	クレヨンしんちゃん
桜田もえ子	クレヨンしんちゃん
ナオキ	クレヨンしんちゃん
堀内	クレヨンしんちゃん
売間久里代	クレヨンしんちゃん
鳩ヶ谷ヨシりん	クレヨンしんちゃん
エンブリヲ	クロスアンジュ_天使と竜の輪舞
ミスティ・ローゼンブルム	クロスアンジュ_天使と竜の輪舞
サラマンディーネ	クロスアンジュ_天使と竜の輪舞
リィザ・ランドッグ	クロスアンジュ_天使と竜の輪舞
ジュライ・飛鳥・ミスルギ	クロスアンジュ_天使と竜の輪舞
ジュリオ・飛鳥・ミスルギ	クロスアンジュ_天使と竜の輪舞
アウラ	クロスアンジュ_天使と竜の輪舞
エレノア	クロスアンジュ_天使と竜の輪舞
エマ・ブロンソン	クロスアンジュ_天使と竜の輪舞
ソフィア・斑鳩・ミスルギ	クロスアンジュ_天使と竜の輪舞
ロザリー	クロスアンジュ_天使と竜の輪舞
ヴィヴィアン	クロスアンジュ_天使と竜の輪舞
モモカ・荻野目	クロスアンジュ_天使と竜の輪舞
エルシャ	クロスアンジュ_天使と竜の輪舞
ドクター・ゲッコー	クロスアンジュ_天使と竜の輪舞
月島一葉	クロスゲーム
月島紅葉	クロスゲーム
滝川あかね	クロスゲーム
三谷	クロスゲーム
東純平	クロスゲーム
ノモ	クロスゲーム
大久保博子	クロスゲーム
三島敬太郎	クロスゲーム
東雄平	クロスゲーム
朝見水輝	クロスゲーム
千田圭一郎	クロスゲーム
寺田	クロスゲーム
月島若葉	クロスゲーム
江原	クロスゲーム
沢口	クロスゲーム
松島	クロスゲーム
及川卓郎	クロスゲーム
中西大気	クロスゲーム
月輪ゴウイチロウ	クロスファイト_ビーダマン
焔ナオヤ	クロスファイト_ビーダマン
黒渕バサラ	クロスファイト_ビーダマン
渡ダイキ	クロスファイト_ビーダマン
龍ヶ崎カケル	クロスファイト_ビーダマン
蠍宮シュモン	クロスファイト_ビーダマン
ホセ	クロスファイト_ビーダマン
御代ヒミコ	クロスファイト_ビーダマン
神扇アスカ	クロスファイト_ビーダマン
拝カゲロウ	クロスファイト_ビーダマン
巻レイジ	クロスファイト_ビーダマン
皇リュウジ	クロスファイト_ビーダマン
蜂須賀ミツル	クロスファイト_ビーダマン
御代カモン	クロスファイト_ビーダマン
アルバココドゥロ	クロスファイト_ビーダマン
来堂オウガ	クロスファイト_ビーダマン
荒野グン	クロスファイト_ビーダマン
不知火ビャクガ	クロスファイト_ビーダマン
白銀スバル	クロスファイト_ビーダマン
角突リュウドウ	クロスファイト_ビーダマン
鮫島カイト	クロスファイト_ビーダマン
鷲村ユキヒデ	クロスファイト_ビーダマン
闇黒寺ゲンタ	クロスファイト_ビーダマン
マグダレーナ	クロノクルセイド
クレア	クロノクルセイド
メアリ	クロノクルセイド
ジェナイ	クロノクルセイド
永宮幸	グラスリップ
深水陽菜	グラスリップ
白崎百	グラスリップ
沖倉駆	グラスリップ
高山やなぎ	グラスリップ
井美雪哉	グラスリップ
白崎祐	グラスリップ
深水透子	グラスリップ
入巣蒔菜	グリザイアの果実
周防天音	グリザイアの果実
小嶺幸	グリザイアの果実
榊由美子	グリザイアの果実
風見雄二	グリザイアの果実
松嶋みちる	グリザイアの果実
飛田	グレートマジンガー
炎ジュン	グレートマジンガー
一平	グロイザーX
エィハ	ケイオスドラゴン_赤竜戦役
ウルリーカ・レデスマ	ケイオスドラゴン_赤竜戦役
イズン	ケイオスドラゴン_赤竜戦役
スアロー	ケイオスドラゴン_赤竜戦役
キリコ	ケメコデラックス!
エムエム	ケメコデラックス!
葵ちゃん	ケメコデラックス!
小林タマ子	ケメコデラックス!
黒崎リョーコ	ケメコデラックス!
大葉久太郎	ケモノヅメ
上月由香	ケモノヅメ
リープ	ケロケロちゃいむ
キャプテンヒカル	ケロケロちゃいむ
晶子	ケロケロちゃいむ
ガミ	ケロロ軍曹
北城睦実	ケロロ軍曹
ポール森山	ケロロ軍曹
日向秋奈	ケロロ軍曹
ダソヌ☆マソ	ケロロ軍曹
タムリン	ケロロ軍曹
ラビー	ケロロ軍曹
スネーク	ケロロ軍曹
西澤梅雄	ケロロ軍曹
ポヤン	ケロロ軍曹
シルヴィ	ケロロ軍曹
ディーノ	ケロロ軍曹
ノントルマの少女	ケロロ軍曹
日向秋	ケロロ軍曹
東谷小雪	ケロロ軍曹
ダンス☆マン	ケロロ軍曹
日向冬樹	ケロロ軍曹
日向夏美	ケロロ軍曹
西澤桃華	ケロロ軍曹
虎男	ケロロ軍曹
お観世	ケロロ軍曹
蜷川あむろ	ケンコー全裸系水泳部_ウミショー
織塚桃子	ケンコー全裸系水泳部_ウミショー
中村恵子	ケンコー全裸系水泳部_ウミショー
村上祐子	ゲゲゲの鬼太郎
モンロー	ゲゲゲの鬼太郎
フランケンシュタイン	ゲゲゲの鬼太郎
毛羽毛現	ゲゲゲの鬼太郎
一刻堂	ゲゲゲの鬼太郎
水虎	ゲゲゲの鬼太郎
地獄童子	ゲゲゲの鬼太郎
グレムリン	ゲゲゲの鬼太郎
鈴木翔太	ゲゲゲの鬼太郎
かまいたち	ゲゲゲの鬼太郎
サトリ	ゲゲゲの鬼太郎
ミウ	ゲゲゲの鬼太郎
牛鬼	ゲゲゲの鬼太郎
あかなめ	ゲゲゲの鬼太郎
ドラキュラ	ゲゲゲの鬼太郎
パシャ	ゲゲゲの鬼太郎
青子	ゲゲゲの鬼太郎
山田秀一	ゲゲゲの鬼太郎
沼御前	ゲゲゲの鬼太郎
百々目鬼	ゲゲゲの鬼太郎
ノラ	ゲゲゲの鬼太郎
亀姫	ゲゲゲの鬼太郎
泥田坊	ゲゲゲの鬼太郎
花子	ゲゲゲの鬼太郎
百目	ゲゲゲの鬼太郎
帝王ゴール	ゲッターロボ
巴武蔵	ゲッターロボ
ジャック・キング	ゲッターロボ
流竜馬	ゲッターロボ
早乙女和子	ゲッターロボG
大枯文次	ゲッターロボG
車弁慶	ゲッターロボG
大道剴	ゲッターロボ號
朝霧麗子	ゲートキーパーズ
橋本大地	ゲートキーパーズ
生沢ルリ子	ゲートキーパーズ
キャナリ	ゲートキーパーズ
影山零士	ゲートキーパーズ
落合恵子	ゲートキーパーズ
鉄恵	ゲートキーパーズ
永瀬伊織	ココロコネクト
宇和千尋	ココロコネクト
円城寺紫乃	ココロコネクト
八重樫太一	ココロコネクト
稲葉姫子	ココロコネクト
青木義文	ココロコネクト
後藤龍善	ココロコネクト
桐山唯	ココロコネクト
八重樫莉奈	ココロコネクト
井上ひかり	ココロ図書館
バイクメン	ココロ図書館
珠音	ココロ図書館
梶原	ココロ図書館
大先生	コスモウォーリアー零
ジュリー	コスモウォーリアー零
大芝	コボちゃん
田畑早苗	コボちゃん
ニルソン	コヨーテ_ラグタイムショー
セプ	コヨーテ_ラグタイムショー
オーガスト	コヨーテ_ラグタイムショー
アンティ	コレクター・ユイ
ウォーウルフ	コレクター・ユイ
黒川良	コレクター・ユイ
ミルフィーユ	コロッケ!
クスクス	コロッケ!
スムージー	コロッケ!
パルメザン	コロッケ!
テキーラ	コロッケ!
アンチョビ	コロッケ!
マフィン	コロッケ!
スパム	コロッケ!
メレンゲ	コロッケ!
牛タン	コロッケ!
ニアリー	ゴクドーくん漫遊記
一休	ゴクドーくん漫遊記
シオ	ゴッドイーター
星野ウララ	ゴッドイーター
雨宮リンドウ	ゴッドイーター
葦原ユノ	ゴッドイーター
ペイラー・榊	ゴッドイーター
真壁テルオミ	ゴッドイーター
空木レンカ	ゴッドイーター
雨宮ツバキ	ゴッドイーター
楠リッカ	ゴッドイーター
フェデリコ・カルーゾ	ゴッドイーター
グレゴリー・ド・グレムスロワ	ゴッドイーター
ブレンダン・バーデル	ゴッドイーター
橘サクヤ	ゴッドイーター
アリサ・イリーニチナ・アミエーラ	ゴッドイーター
ソーマ・シックザール	ゴッドイーター
リヴィ・コレット	ゴッドイーター
レア・クラウディウス	ゴッドイーター
マスク・ド・オウガ	ゴッドイーター
ジュリウス・ヴィスコンティ	ゴッドイーター
ブラー	ゴッドマジンガー
ジョン・ブラウン	ゴーストハント
原真砂子	ゴーストハント
高橋優子	ゴーストハント
滝川法生	ゴーストハント
森まどか	ゴーストハント
クリスト	サイコアーマー・ゴーバリアン
メリア	サイコアーマー・ゴーバリアン
与作	サイボットロボッチ
コズミ博士	サイボーグ009
カボレ	サイボーグ009
アキレス	サイボーグ009
ナタリー	サイボーグ009
ブラウン	サイボーグ009
フィル	サイボーグ009
ビッグ・ボス	サイボーグクロちゃん
ロミオ	サイボーグクロちゃん
フォックス	サイボーグクロちゃん
ジュリエット	サイボーグクロちゃん
ミッキー・ローク	サイボーグクロちゃん
中松	サイボーグクロちゃん
鈴木一郎	サイボーグクロちゃん
バイス	サイボーグクロちゃん
ニャンニャンアーミー3号	サイボーグクロちゃん
マサヒロ	サザエさん
矢部	サザエさん
岡村隆史	サザエさん
龍海	サザエさん
中居正広	サザエさん
岡島	サザエさん
絹江	サザエさん
さんま	サザエさん
江藤	サザエさん
駒子	サザエさん
橋本和美	サザエさん
又吉	サザエさん
八木亜希子	サザエさん
江頭	サザエさん
タクヤ	サザエさん
小松崎	サザエさん
荒川静香	サザエさん
千造	サザエさん
富士男	サザエさん
田河水泡	サザエさん
福井謙二	サザエさん
中居	サザエさん
露木茂	サザエさん
岡村	サザエさん
矢部浩之	サザエさん
加代	サザエさん
恵介	サザエさん
ビヨンド・フラメンコ	サムライフラメンコ
戸塚	サムライフラメンコ
今野明	サムライフラメンコ
後藤英徳	サムライフラメンコ
キリング・ジョーク	サムライフラメンコ
千早恵	サーバント×サービス
田中譲二	サーバント×サービス
デイジー	サーバント×サービス
一宮大志	サーバント×サービス
一宮塔子	サーバント×サービス
百井花音	サーバント×サービス
三好紗耶	サーバント×サービス
長谷部豊	サーバント×サービス
長谷部薫	サーバント×サービス
百井兼蔵	サーバント×サービス
ピグ	ザ☆ウルトラマン
ロト	ザ☆ウルトラマン
パブロ	ザ☆ウルトラマン
岩本虎眼	シグルイ
徳川忠長	シグルイ
山崎九郎右衛門	シグルイ
藤木源之助	シグルイ
伊良子清玄	シグルイ
近藤涼之介	シグルイ
牛股権左衛門	シグルイ
茂助	シグルイ
大坪	シグルイ
鳥居成次	シグルイ
柳生宗矩	シグルイ
文伽	シゴフミ
カナカ	シゴフミ
緑川纈	シドニアの騎士
白羽衣つむぎ	シドニアの騎士
岐神海蘊	シドニアの騎士
科戸瀬ユレ	シドニアの騎士
サマリ・イッタン	シドニアの騎士
山野栄子	シドニアの騎士
高橋亮子	シドニアの騎士
ヒ山ララァ	シドニアの騎士
岐神海苔夫	シドニアの騎士
市ヶ谷テルル	シドニアの騎士
斎藤ヒロキ	シドニアの騎士
弦打攻市	シドニアの騎士
落合	シドニアの騎士
星白閑	シドニアの騎士
科戸瀬イザナ	シドニアの騎士
椎名夏音	シャイニング・ティアーズ・クロス・ウィンド
ジード	シャイニング・ティアーズ・クロス・ウィンド
ライヒ	シャイニング・ティアーズ・クロス・ウィンド
ゼクティ・アイン	シャイニング・ティアーズ・クロス・ウィンド
マオ	シャイニング・ティアーズ・クロス・ウィンド
呉羽冬華	シャイニング・ティアーズ・クロス・ウィンド
ブランネージュ	シャイニング・ティアーズ・クロス・ウィンド
シャオメイ	シャイニング・ハーツ_〜幸せのパン〜
ミストラル・ネレイス	シャイニング・ハーツ_〜幸せのパン〜
アミル	シャイニング・ハーツ_〜幸せのパン〜
ラナ	シャイニング・ハーツ_〜幸せのパン〜
ハンク	シャイニング・ハーツ_〜幸せのパン〜
ガデム	シャイニング・ハーツ_〜幸せのパン〜
ソルベエ	シャイニング・ハーツ_〜幸せのパン〜
マキシマ・エンフィールド	シャイニング・ハーツ_〜幸せのパン〜
ラグナス	シャイニング・ハーツ_〜幸せのパン〜
イーリア	シャイニング・ハーツ_〜幸せのパン〜
アルヴィン	シャイニング・ハーツ_〜幸せのパン〜
ファントム・クイーンEX-X	シャイニング・ハーツ_〜幸せのパン〜
バルダー	シャイニング・ハーツ_〜幸せのパン〜
ゾリャー・ガガーリク	シャーマンキング
ラキスト・ラッソ	シャーマンキング
オジー	シャーマンキング
カンナ・ビスマルク	シャーマンキング
李白竜	シャーマンキング
小山田まん太	シャーマンキング
アイアンメイデン・ジャンヌ	シャーマンキング
マルコ・ラッソ	シャーマンキング
阿弥陀丸	シャーマンキング
ミイネ・モンゴメリ	シャーマンキング
アシル	シャーマンキング
玉村たまお	シャーマンキング
碓氷ピリカ	シャーマンキング
マリオン・ファウナ	シャーマンキング
麻倉茎子	シャーマンキング
道潤	シャーマンキング
馬孫	シャーマンキング
メラニー	シャーマンキング
リゼルグ・ダイゼル	シャーマンキング
マイア	シャーマンキング
道蓮	シャーマンキング
梅宮竜之介	シャーマンキング
ラジム	シャーマンキング
蜥蜴郎	シャーマンキング
マタムネ	シャーマンキング
麻倉幹久	シャーマンキング
ジョン・デンバット	シャーマンキング
ラダー	シャーマンキング
Duke	シュガシュガルーン
アンディ	シルクロード少年_ユート
チャーリー	シルクロード少年_ユート
イザベル	シンデレラ物語
パピー	シンデレラ物語
シャルル	シンデレラ物語
マルセル	シンデレラ物語
ジル	シートン動物記_くまの子ジャッキー
リョウ	ジェネレイターガウル
チチ	ジェネレイターガウル
アレクサンド・コーガン	ジャングルの王者ターちゃん♡
アイアンマスク	ジャングルの王者ターちゃん♡
蓮苞	ジャングルの王者ターちゃん♡
リンリン	ジャングルの王者ターちゃん♡
マット・コーガン	ジャングルの王者ターちゃん♡
マシューズ	ジャングルの王者ターちゃん♡
リサ・コーガン	ジャングルの王者ターちゃん♡
梁師範	ジャングルの王者ターちゃん♡
ロド・ソドム	ジャングルの王者ターちゃん♡
ベイツ	ジャングルの王者ターちゃん♡
ペドロ・カズマイヤー	ジャングルの王者ターちゃん♡
ダグラス	ジャングルの王者ターちゃん♡
ヘレン野口	ジャングルの王者ターちゃん♡
エテ吉	ジャングルの王者ターちゃん♡
マイケル・コーガン	ジャングルの王者ターちゃん♡
アナベベ	ジャングルの王者ターちゃん♡
趙	ジャングルの王者ターちゃん♡
ダマ	ジャングルはいつもハレのちグゥ
アディ	ジャングルはいつもハレのちグゥ
グゥ	ジャングルはいつもハレのちグゥ
マリィ	ジャングルはいつもハレのちグゥ
チェット	ジャングルはいつもハレのちグゥ
ウェダ	ジャングルはいつもハレのちグゥ
トポステ	ジャングルはいつもハレのちグゥ
ヒゲオヤジ	ジャングル大帝
ライヤ	ジャングル大帝
パオラ	ジャングル大帝
トト	ジャングル大帝
パオパオ	ジャングル黒べえ
カイゼル	ジュエルペット_きら☆デコッ!
エクレン	ジュエルペット_きら☆デコッ!
ブラウニー	ジュエルペット_きら☆デコッ!
桜モニカ	ジュエルペット_てぃんくる☆
フェアリーナ	ジュエルペット_てぃんくる☆
サガン	ジュエルペット_てぃんくる☆
神内祐馬	ジュエルペット_てぃんくる☆
桜あかり	ジュエルペット_てぃんくる☆
アンジェリーナ	ジュエルペット_てぃんくる☆
根本クララ	ジュエルペット_サンシャイン
八木沼	ジュエルペット_サンシャイン
白石御影	ジュエルペット_サンシャイン
菊池かえで	ジュエルペット_サンシャイン
浅香ひなた	ジュエルペット_サンシャイン
藍沢晶子	ジュエルペット_サンシャイン
黒田真砂	ジュエルペット_サンシャイン
ネジ川テツオ	ジュエルペット_サンシャイン
三原純子	ジュエルペット_サンシャイン
平和泉	ジュエルペット_ハッピネス
真田幸介	ジュエルペット_ハッピネス
浅野匠	ジュエルペット_ハッピネス
あずさ先生	ジュエルペット_ハッピネス
北島のばら	ジュエルペット_ハッピネス
華山るるか	ジュエルペット_ハッピネス
花園まりえ	ジュエルペット_ハッピネス
袴田サチ	ジュエルペット_ハッピネス
餅田むつみ	ジュエルペット_ハッピネス
ジュエリーナ	ジュエルペット_ハッピネス
近衛ねね	ジュエルペット_ハッピネス
ミヤ	ジュエルペット_マジカルチェンジ
カイヤ	ジュエルペット_マジカルチェンジ
秋菜	ジュエルペット_マジカルチェンジ
雲母あいり	ジュエルペット_マジカルチェンジ
キング	ジュエルペット_マジカルチェンジ
ラリマー	ジュエルペット_マジカルチェンジ
チターナ	ジュエルペット_マジカルチェンジ
ラブラ	ジュエルペット_マジカルチェンジ
エンジェラ	ジュエルペット_マジカルチェンジ
とき子	ジュエルペット_マジカルチェンジ
サフィー	ジュエルペット_マジカルチェンジ
アレク	ジュエルペット_マジカルチェンジ
雲母朔太郎	ジュエルペット_マジカルチェンジ
福王子ローラ	ジュエルペット_マジカルチェンジ
コール	ジュエルペット_マジカルチェンジ
チャチャ	ジーンシャフト
アシモフ	ジーンシャフト
フミ	ジーンシャフト
グロリア	ジーンシャフト
カレン	ジーンシャフト
ドライ6	ジーンダイバー
フラウ・ニー	ジーンダイバー
バスドラ	スイートプリキュア♪
南野美空	スイートプリキュア♪
メフィスト	スイートプリキュア♪
調辺音吉	スイートプリキュア♪
王子正宗	スイートプリキュア♪
南野奏介	スイートプリキュア♪
北条団	スイートプリキュア♪
ファルセット	スイートプリキュア♪
東山聖歌	スイートプリキュア♪
園宮可憐	スカイガールズ
門脇曹一郎	スカイガールズ
九堂じゅりあ	スカイガールズ
エリーゼ・フォン・ディートリッヒ	スカイガールズ
アイーシャ・クリシュナム	スカイガールズ
藤枝七恵	スカイガールズ
冬后蒼哉	スカイガールズ
御子神嵐子	スカイガールズ
御子神晴子	スカイガールズ
最上キョーコ	スキップ・ビート!
瓜核	スクライド
カズマ	スクライド
無常矜侍	スクライド
橘あすか	スクライド
来夏月爽	スクライド
雲慶	スクライド
劉大蓮	スクライド
由詑かなみ	スクライド
君島邦彦	スクライド
ラクウェル・カスール	スクラップド・プリンセス
冴子	スクールランブル
郡山	スクールランブル
加藤	スクールランブル
麻生広義	スクールランブル
塚本八雲	スクールランブル
三沢伸	スクールランブル
笹倉葉子	スクールランブル
吾郎	スクールランブル
西本願司	スクールランブル
大塚舞	スクールランブル
播磨修治	スクールランブル
一条かれん	スクールランブル
花井春樹	スクールランブル
東郷雅一	スクールランブル
刑部絃子	スクールランブル
高野晶	スクールランブル
田中一也	スクールランブル
サラ・アディエマス	スクールランブル
烏丸大路	スクールランブル
今鳥恭介	スクールランブル
トニー	スケアクロウマン
スコット	スケアクロウマン
ミーシャ	スケアクロウマン
スティーブ	スケアクロウマン
マイケル	スケアクロウマン
シュタイン	スケアクロウマン
ヘンリー	スケアクロウマン
アーネスト	スケアクロウマン
ダニー	スケアクロウマン
アイリーン	スケアクロウマン
根岸大地	スケッチブック_〜full_color's〜
栗原渚	スケッチブック_〜full_color's〜
ミケ	スケッチブック_〜full_color's〜
麻生夏海	スケッチブック_〜full_color's〜
梶原青	スケッチブック_〜full_color's〜
大庭月夜	スケッチブック_〜full_color's〜
佐々木樹々	スケッチブック_〜full_color's〜
空閑木陰	スケッチブック_〜full_color's〜
神谷朝霞	スケッチブック_〜full_color's〜
鳥飼葉月	スケッチブック_〜full_color's〜
ハー	スケッチブック_〜full_color's〜
氷室風	スケッチブック_〜full_color's〜
田辺涼	スケッチブック_〜full_color's〜
プリシス・F・ノイマン	スターオーシャンEX
アシュトン・アンカース	スターオーシャンEX
ウルルン	スターオーシャンEX
エルネスト・レヴィード	スターオーシャンEX
ディアス・フラック	スターオーシャンEX
レナ・ランフォード	スターオーシャンEX
ギョロ	スターオーシャンEX
濱田	スティッチ!
野呂	スティッチ!
クライド	スティッチ!
ユウナ	スティッチ!
ボニー	スティッチ!
レイカ	スティッチ!
スパーキー	スティッチ!
ガントゥ	スティッチ!
沢井	スティッチ!
豊田	スティッチ!
フランケン	スティッチ!
レミー	スティッチ!
前田さん	スティッチ!
美月	スティッチ!
ルーベン	スティッチ!
サンド	スティッチ!
ピーコ	スティッチ!
コージ	スティッチ!
マキ子	スティッチ!
陸奥ほのか	ステラ女学院高等科C3部
鹿島そのら	ステラ女学院高等科C3部
日向八千代	ステラ女学院高等科C3部
アンナ・フェラーラ	ストライクウィッチーズ
宮藤一郎	ストライクウィッチーズ
ハイデマリー・W・シュナウファー	ストライクウィッチーズ
マルチナ・クレスピ	ストライクウィッチーズ
マリア・ピア・ディ・ロマーニャ	ストライクウィッチーズ
山川藤宏	ストライクウィッチーズ
ヴァルトルート・クルピンスキー	ストライクウィッチーズ
グンドュラ・ラル	ストライクウィッチーズ
クルト・フラッハフェルト	ストライクウィッチーズ
ミーナ・ディートリンデ・ヴィルケ	ストライクウィッチーズ
服部静夏	ストライクウィッチーズ
下原定子	ストライクウィッチーズ
エディータ・ロスマン	ストライクウィッチーズ
雁淵ひかり	ストライクウィッチーズ
ニッカ・エドワーディン・カタヤイネン	ストライクウィッチーズ
秋本芳子	ストライクウィッチーズ
杉田淳三郎	ストライクウィッチーズ
フェルナンディア・マルヴェッツィ	ストライクウィッチーズ
リネット・ビショップ	ストライクウィッチーズ
エイラ・イルマタル・ユーティライネン	ストライクウィッチーズ
土方圭助	ストライクウィッチーズ
坂本美緒	ストライクウィッチーズ
樽宮敬喜	ストライクウィッチーズ
トレヴァー・マロニー	ストライクウィッチーズ
ウルスラ・ハルトマン	ストライクウィッチーズ
ライーサ・ペットゲン	ストライクウィッチーズ
山川美千子	ストライクウィッチーズ
管野直枝	ストライクウィッチーズ
ルチアナ・マッツェイ	ストライクウィッチーズ
宮藤清佳	ストライクウィッチーズ
笹崎岬	ストライク・ザ・ブラッド
天塚汞	ストライク・ザ・ブラッド
ラ・フォリア・リハヴァイン	ストライク・ザ・ブラッド
叶瀬夏音	ストライク・ザ・ブラッド
モグワイ	ストライク・ザ・ブラッド
暁零菜	ストライク・ザ・ブラッド
暁深森	ストライク・ザ・ブラッド
進藤美波	ストライク・ザ・ブラッド
サナ	ストライク・ザ・ブラッド
藍羽浅葱	ストライク・ザ・ブラッド
煌坂紗矢華	ストライク・ザ・ブラッド
ディミトリエ・ヴァトラー	ストライク・ザ・ブラッド
アヴローラ・フロレスティーナ	ストライク・ザ・ブラッド
築島倫	ストライク・ザ・ブラッド
姫柊雪菜	ストライク・ザ・ブラッド
仙都木阿夜	ストライク・ザ・ブラッド
南宮那月	ストライク・ザ・ブラッド
矢瀬基樹	ストライク・ザ・ブラッド
暁凪沙	ストライク・ザ・ブラッド
池田空	ストラトス・フォー
ロバート・レイノルズ	ストラトス・フォー
岡部いさく	ストラトス・フォー
菊原香鈴	ストラトス・フォー
飛龍	ストリートファイターII_V
キャミィ	ストリートファイターII_V
ダルシム	ストリートファイターII_V
サガット	ストリートファイターII_V
春麗	ストリートファイターII_V
ナッシュ	ストリートファイターII_V
バイソン	ストリートファイターII_V
ザンギエフ	ストリートファイターII_V
ガイル	ストリートファイターII_V
シュラ	ストレンジドーン
ダール	ストレンジドーン
マニ	ストレンジドーン
美羽	ストレンジ・プラス
巧美	ストレンジ・プラス
香織	ストレンジ・プラス
貴世子	ストレンジ・プラス
正宗	ストレンジ・プラス
雅史	ストレンジ・プラス
管野	ストレンジ・プラス
瀬戸川	ストレンジ・プラス
シャドウ	スパイダーライダーズ_〜オラクルの勇者たち〜
ブレイド	スパイダーライダーズ_〜オラクルの勇者たち〜
塩川	スパロウズホテル
フェルディナン	スペース☆ダンディ
マミタス	スペース☆ダンディ
パンツ星人	スペース☆ダンディ
ゲル博士	スペース☆ダンディ
エシメ	スペース☆ダンディ
ミャウ	スペース☆ダンディ
ペリー提督	スペース☆ダンディ
033H	スペース☆ダンディ
ドルフ	スペース☆ダンディ
ウクレレ男	スペース☆ダンディ
アデリー	スペース☆ダンディ
バッドエンドハッピー	スマイルプリキュア!
尾ノ後きよみ	スマイルプリキュア!
青木淳之介	スマイルプリキュア!
宗本しんや	スマイルプリキュア!
日野げんき	スマイルプリキュア!
藤川あみ	スマイルプリキュア!
黄瀬勇一	スマイルプリキュア!
ロイヤルクイーン	スマイルプリキュア!
木村さとし	スマイルプリキュア!
日野大悟	スマイルプリキュア!
ピエーロ	スマイルプリキュア!
岡田まゆ	スマイルプリキュア!
入江	スマイルプリキュア!
木角まゆみ	スマイルプリキュア!
バッドエンドピース	スマイルプリキュア!
FUJIWARA	スマイルプリキュア!
北原ともふみ	スマイルプリキュア!
本田あや	スマイルプリキュア!
バッドエンドサニー	スマイルプリキュア!
星空博司	スマイルプリキュア!
緑川こうた	スマイルプリキュア!
星空タエ	スマイルプリキュア!
寺田るな	スマイルプリキュア!
ブライアン・テイラー	スマイルプリキュア!
バッドエンドビューティ	スマイルプリキュア!
青木曾太郎	スマイルプリキュア!
緑川けいた	スマイルプリキュア!
緑川ひな	スマイルプリキュア!
バッドエンドマーチ	スマイルプリキュア!
緑川源次	スマイルプリキュア!
緑川ゆうた	スマイルプリキュア!
日野正子	スマイルプリキュア!
青木静子	スマイルプリキュア!
深澤	スマイルプリキュア!
星空育代	スマイルプリキュア!
井上せいじ	スマイルプリキュア!
柏本まゆか	スマイルプリキュア!
金本ひろこ	スマイルプリキュア!
グレイス	スレイヤーズ
アルフレッド	スレイヤーズ
コピー・レゾ	スレイヤーズ
ディルギア	スレイヤーズ
ハルシフォム	スレイヤーズ
ディオル	スレイヤーズ
ヌンサ	スレイヤーズ
白蛇のナーガ	スレイヤーズ
フク	スーキャット
フランツ	スーパードール★リカちゃん
ヒデ	スーパードール★リカちゃん
マーニャ	スーパービックリマン
アンドロココ	スーパービックリマン
ヘラクライスト	スーパービックリマン
スーパーデビル	スーパービックリマン
アムル	スーパービックリマン
輝島ナイト	セイクリッドセブン
劉翡翠	セイクリッドセブン
伊藤若菜	セイクリッドセブン
鏡誠	セイクリッドセブン
丹童子アルマ	セイクリッドセブン
山口揚羽	セイクリッドセブン
研美悠士	セイクリッドセブン
藍羽ルリ	セイクリッドセブン
藍羽アオイ	セイクリッドセブン
まりん	セイバーマリオネットJ
玉三郎	セイバーマリオネットJ
ブラッドベリー	セイバーマリオネットJ
藤山起目粒	セクシーコマンドー外伝_すごいよ!!マサルさん
花中島マサル	セクシーコマンドー外伝_すごいよ!!マサルさん
ヨロシク仮面	セクシーコマンドー外伝_すごいよ!!マサルさん
川島	セクシーコマンドー外伝_すごいよ!!マサルさん
近藤真茶彦	セクシーコマンドー外伝_すごいよ!!マサルさん
さかきばらのぶゆき	セクシーコマンドー外伝_すごいよ!!マサルさん
石黒	セクシーコマンドー外伝_すごいよ!!マサルさん
田中スーザンふ美子	セクシーコマンドー外伝_すごいよ!!マサルさん
こぶいち	セクシーコマンドー外伝_すごいよ!!マサルさん
凛堂あやか	セラフィムコール
桜瀬ちなみ	セラフィムコール
村雨紫苑	セラフィムコール
村雨桜	セラフィムコール
紅かすみ	セラフィムコール
アンリエッタ・ド・トリステイン	ゼロの使い魔
フレイム	ゼロの使い魔
オスマン	ゼロの使い魔
ガレット	ゼロの使い魔
アンジェロ	ゼロの使い魔
ミシェル	ゼロの使い魔
ケティ・ド・ラ・ロッタ	ゼロの使い魔
アニエス・シュヴァリエ・ド・ミラン	ゼロの使い魔
デルフリンガー	ゼロの使い魔
ジャネット	ゼロの使い魔
スティックス	ゼロの使い魔
ダミアン	ゼロの使い魔
ジョー・ケリー	ゼロテスター
ヒロシ	ゼロテスター
マリー・ミョルニル	ソウルイーター
キミアール・ディール	ソウルイーター
パトリシア・トンプソン	ソウルイーター
ブレア	ソウルイーター
レイチェル	ソウルイーター
死神様	ソウルイーター
阿修羅	ソウルイーター
モスキート	ソウルイーター
グリモア	ソウルイーター
弓梓	ソウルイーター
ギリコ	ソウルイーター
エリザベス・トンプソン	ソウルイーター
クロナ	ソウルイーター
ラグナロク	ソウルイーター
アローン	ソウルイーター
ブラック☆スター	ソウルイーターノット!
デス・ザ・キッド	ソウルイーターノット!
シャウラ・ゴーゴン	ソウルイーターノット!
シド・バレット	ソウルイーターノット!
多々音めめ	ソウルイーターノット!
フランケン・シュタイン	ソウルイーターノット!
ジャクリーン・オー・ランタン・デュプレ	ソウルイーターノット!
ハーバー・ド・エクレール	ソウルイーターノット!
レイド	ソウルイーターノット!
アーロン	ソウルイーターノット!
昊	ソウルイーターノット!
シャドウ・ザ・ヘッジホッグ	ソニックX
ソニック・ザ・ヘッジホッグ	ソニックX
クリーム・ザ・ラビット	ソニックX
スカーレット・ガルシア	ソニックX
フランシス	ソニックX
ビッグ・ザ・キャット	ソニックX
ボコー	ソニックX
ナックルズ・ザ・エキドゥナ	ソニックX
ベクター・ザ・クロコダイル	ソニックX
クリストファー・ソーンダイク	ソニックX
スチュワート	ソニックX
ユキコ	ソ・ラ・ノ・ヲ・ト
オリガ	ソ・ラ・ノ・ヲ・ト
クラウス	ソ・ラ・ノ・ヲ・ト
和宮梨旺	ソ・ラ・ノ・ヲ・ト
ナオミ	ソ・ラ・ノ・ヲ・ト
ユミナ	ソ・ラ・ノ・ヲ・ト
寒凪乃絵留	ソ・ラ・ノ・ヲ・ト
墨埜谷暮羽	ソ・ラ・ノ・ヲ・ト
ヨルコ	ソードアート・オンライン
トール	ソードアート・オンライン
アスナ	ソードアート・オンライン
シリカ	ソードアート・オンライン
リズベット	ソードアート・オンライン
ニシダ	ソードアート・オンライン
ジュン	ソードアート・オンライン
倉橋	ソードアート・オンライン
須郷伸之	ソードアート・オンライン
サーシャ	ソードアート・オンライン
アリシャ・ルー	ソードアート・オンライン
エギル	ソードアート・オンライン
ジョニー・ブラック	ソードアート・オンライン
結城京子	ソードアート・オンライン
結城彰三	ソードアート・オンライン
ユージーン	ソードアート・オンライン
シグルド	ソードアート・オンライン
遠藤	ソードアート・オンライン
リーファ	ソードアート・オンライン
サチ	ソードアート・オンライン
キリト	ソードアート・オンライン
カインズ	ソードアート・オンライン
ユウキ	ソードアート・オンライン
キバオウ	ソードアート・オンライン
シノン	ソードアート・オンライン
菊岡誠二郎	ソードアート・オンライン
スクルド	ソードアート・オンライン
シュミット	ソードアート・オンライン
PoH	ソードアート・オンライン
ローザ	ゾイド_-ZOIDS-
ラルフ	ゾイド_-ZOIDS-
アーバイン	ゾイド_-ZOIDS-
ハルフォード	ゾイド_-ZOIDS-
フィーネ・エレシーヌ・リネ	ゾイド_-ZOIDS-
ミューラー	ゾイド_-ZOIDS-
ファントム	ゾイド_-ZOIDS-
バン・フライハイト	ゾイド_-ZOIDS-
リーゼ	ゾイド_-ZOIDS-
トーマ・リヒャルト・シュバルツ	ゾイド_-ZOIDS-
ギュンター・プロイツェン	ゾイド_-ZOIDS-
カール・リヒテン・シュバルツ	ゾイド_-ZOIDS-
レイヴン	ゾイド_-ZOIDS-
ハーディン	ゾイド_-ZOIDS-
ビーピー	ゾイド_-ZOIDS-
ガボール	ゾイドジェネシス
コトナ・エレガンス	ゾイドジェネシス
ホー	ゾイドジェネシス
サイコ	ゾイドジェネシス
パラ	ゾイドジェネシス
ガゼル	ゾイドジェネシス
レ・ミィ	ゾイドジェネシス
ルージ・ファミロン	ゾイドジェネシス
ボーン	ゾイドフューザーズ
ディド	ゾイドフューザーズ
アルファ・リヒター	ゾイドフューザーズ
グラハム	ゾイドフューザーズ
エミー	ゾイドフューザーズ
ダン	ゾイドフューザーズ
バース	ゾイドフューザーズ
ワッツ	ゾイドフューザーズ
リーリン	ゾイドフューザーズ
ドク	ゾイドフューザーズ
サンドラ	ゾイドフューザーズ
バートン	ゾイドフューザーズ
ジャッキー	ゾイドフューザーズ
山口健	ダイヤのA
落合博光	ダイヤのA
瀬戸拓馬	ダイヤのA
片岡鉄心	ダイヤのA
原田雅功	ダイヤのA
国見	ダイヤのA
増子透	ダイヤのA
御幸一也	ダイヤのA
秋葉一真	ダイヤのA
倉持洋一	ダイヤのA
真中要	ダイヤのA
大西	ダイヤのA
荒木伊知郎	ダイヤのA
奥村光舟	ダイヤのA
向井太陽	ダイヤのA
渡辺久志	ダイヤのA
滝川・クリス・優	ダイヤのA
日所好己	ダイヤのA
三島優太	ダイヤのA
吉川春乃	ダイヤのA
神谷カルロス俊樹	ダイヤのA
小湊亮介	ダイヤのA
楠木文哉	ダイヤのA
天久光聖	ダイヤのA
梅本幸子	ダイヤのA
宮内啓介	ダイヤのA
蒼月若菜	ダイヤのA
木島澪	ダイヤのA
真木洋介	ダイヤのA
乾憲剛	ダイヤのA
小湊春市	ダイヤのA
結城哲也	ダイヤのA
白州健二郎	ダイヤのA
若林豪	ダイヤのA
林慎一	ダイヤのA
J・アニマル・M	ダイヤのA
白河勝之	ダイヤのA
丹波光一郎	ダイヤのA
坂井一郎	ダイヤのA
小川常松	ダイヤのA
国友広重	ダイヤのA
沢村栄徳	ダイヤのA
財前直行	ダイヤのA
多田野樹	ダイヤのA
伊佐敷純	ダイヤのA
轟雷蔵	ダイヤのA
三野	ダイヤのA
真田俊平	ダイヤのA
成宮鳴	ダイヤのA
梅宮聖一	ダイヤのA
松原南朋	ダイヤのA
降谷暁	ダイヤのA
大田	ダイヤのA
東清国	ダイヤのA
川上憲史	ダイヤのA
藤原貴子	ダイヤのA
白鳥	ダイヤのA
夏川唯	ダイヤのA
松本隆広	ダイヤのA
田原利彦	ダイヤのA
結城将司	ダイヤのA
福田	ダイヤのA
轟雷市	ダイヤのA
長緒アキラ	ダイヤのA
高島礼	ダイヤのA
平井翼	ダイヤのA
樋笠昭二	ダイヤのA
稲本正明	ダイヤのA
吉沢秀明	ダイヤのA
前園健太	ダイヤのA
大神さくら	ダンガンロンパ_希望の学園と絶望の高校生_The_Animation
石丸清多夏	ダンガンロンパ_希望の学園と絶望の高校生_The_Animation
モノクマ	ダンガンロンパ_希望の学園と絶望の高校生_The_Animation
不二咲千尋	ダンガンロンパ_希望の学園と絶望の高校生_The_Animation
苗木誠	ダンガンロンパ_希望の学園と絶望の高校生_The_Animation
朝日奈葵	ダンガンロンパ_希望の学園と絶望の高校生_The_Animation
桑田怜恩	ダンガンロンパ_希望の学園と絶望の高校生_The_Animation
ジェノサイダー翔	ダンガンロンパ_希望の学園と絶望の高校生_The_Animation
十神白夜	ダンガンロンパ_希望の学園と絶望の高校生_The_Animation
腐川冬子	ダンガンロンパ_希望の学園と絶望の高校生_The_Animation
山田一二三	ダンガンロンパ_希望の学園と絶望の高校生_The_Animation
江ノ島盾子	ダンガンロンパ_希望の学園と絶望の高校生_The_Animation
セレスティア・ルーデンベルク	ダンガンロンパ_希望の学園と絶望の高校生_The_Animation
霧切仁	ダンガンロンパ_希望の学園と絶望の高校生_The_Animation
アルターエゴ	ダンガンロンパ_希望の学園と絶望の高校生_The_Animation
大和田紋土	ダンガンロンパ_希望の学園と絶望の高校生_The_Animation
霧切響子	ダンガンロンパ_希望の学園と絶望の高校生_The_Animation
舞園さやか	ダンガンロンパ_希望の学園と絶望の高校生_The_Animation
シル・フローヴァ	ダンジョンに出会いを求めるのは間違っているだろうか
リュー・リオン	ダンジョンに出会いを求めるのは間違っているだろうか
ガネーシャ	ダンジョンに出会いを求めるのは間違っているだろうか
エイナ・チュール	ダンジョンに出会いを求めるのは間違っているだろうか
ロキ	ダンジョンに出会いを求めるのは間違っているだろうか
ヴェルフ・クロッゾ	ダンジョンに出会いを求めるのは間違っているだろうか
ティオナ・ヒリュテ	ダンジョンに出会いを求めるのは間違っているだろうか
ヤマト・命	ダンジョンに出会いを求めるのは間違っているだろうか
アイズ・ヴァレンシュタイン	ダンジョンに出会いを求めるのは間違っているだろうか
ゼウス	ダンジョンに出会いを求めるのは間違っているだろうか
フィン・ディムナ	ダンジョンに出会いを求めるのは間違っているだろうか
ティオネ・ヒリュテ	ダンジョンに出会いを求めるのは間違っているだろうか
ベート・ローガ	ダンジョンに出会いを求めるのは間違っているだろうか
デメテル	ダンジョンに出会いを求めるのは間違っているだろうか
リリルカ・アーデ	ダンジョンに出会いを求めるのは間違っているだろうか
レムス	ダンス_イン_ザ_ヴァンパイアバンド
ヒステリカ	ダンス_イン_ザ_ヴァンパイアバンド
ハインリヒ	ダンス_イン_ザ_ヴァンパイアバンド
カミーユ	ダンス_イン_ザ_ヴァンパイアバンド
ミナ・ツェペッシュ	ダンス_イン_ザ_ヴァンパイアバンド
クララ	ダンス_イン_ザ_ヴァンパイアバンド
三枝由紀	ダンス_イン_ザ_ヴァンパイアバンド
ジジ	ダンス_イン_ザ_ヴァンパイアバンド
鏑木アキラ	ダンス_イン_ザ_ヴァンパイアバンド
ネリー	ダンス_イン_ザ_ヴァンパイアバンド
彦坂	ダンス_イン_ザ_ヴァンパイアバンド
ネロ	ダンス_イン_ザ_ヴァンパイアバンド
ダリアン	ダンタリアンの書架
ラズ	ダンタリアンの書架
伊丹キョウジ	ダンボール戦機
宇崎悠介	ダンボール戦機
金箱スズネ	ダンボール戦機
古城タケル	ダンボール戦機
磯谷ゲンドウ	ダンボール戦機
瀬名アラタ	ダンボール戦機
マングース	ダンボール戦機
山野バン	ダンボール戦機
トメさん	ダンボール戦機
オタクロス	ダンボール戦機
大門ジョセフィーヌ	ダンボール戦機
宇崎拓也	ダンボール戦機
大空遥	ダンボール戦機
剣菱ワタル	ダンボール戦機
青島カズヤ	ダンボール戦機
白小路オトヒメ	ダンボール戦機
ジェシカ・カイオス	ダンボール戦機
三影ミカ	ダンボール戦機
出雲ハルキ	ダンボール戦機
霧島平治	ダンボール戦機
白牙ムサシ	ダンボール戦機
仙道ダイキ	ダンボール戦機
大空ヒロ	ダンボール戦機
ジャック・ジェラート	ダンボール戦機
郷田ハンゾウ	ダンボール戦機
星原ヒカル	ダンボール戦機
灰原ユウヤ	ダンボール戦機
キャサリン・ルース	ダンボール戦機
ユキ	ダンボール戦機
霧野紗枝	ダンボール戦機
波野リンコ	ダンボール戦機
財前宗助	ダンボール戦機
谷下アキト	ダンボール戦機
角馬王将	ダンボール戦機
沖田ヒナコ	ダンボール戦機
石森里奈	ダンボール戦機
嵐山ブンタ	ダンボール戦機
美都玲奈	ダンボール戦機
鴻森シスイ	ダンボール戦機
ピノン	ダンボール戦機
オーウェン・カイオス	ダンボール戦機
吹野タダシ	ダンボール戦機
法条ムラク	ダンボール戦機
猿田学	ダンボール戦機
アラン・ウォーゼン	ダンボール戦機
鹿島ユノ	ダンボール戦機
岸川セイリュウ	ダンボール戦機
檜山蓮	ダンボール戦機
シャーロット・レイン	ダンボール戦機
アンドレイ・グレゴリー	ダンボール戦機
仙道キヨカ	ダンボール戦機
ビリー・スタリオン	ダンボール戦機
園山ハナコ	ダンボール戦機
ジャッカル	ダンボール戦機
ミゼル	ダンボール戦機
シャーリー	ダンボール戦機
神谷コウスケ	ダンボール戦機
川村アミ	ダンボール戦機
石川タケヒロ	ダンボール戦機
浜岬タイガ	ダンボール戦機
山野淳一郎	ダンボール戦機
大口寺リュウ	ダンボール戦機
高崎ケンタロウ	ダンボール戦機
東郷リクヤ	ダンボール戦機
乾カゲトラ	ダンボール戦機
古城アスカ	ダンボール戦機
風摩キリト	ダンボール戦機
朝比奈コウタ	ダンボール戦機
細野サクヤ	ダンボール戦機
風陣カイト	ダンボール戦機
セリカ	テガミバチ
Dr.サンダーランドJr.	テガミバチ
ダーウィン	テガミバチ
シグナレス	テガミバチ
ジール	テガミバチ
Dr.サンダーランド	テガミバチ
Noir	テガミバチ
鬼塚慶次	テラフォーマーズ
本多晃	テラフォーマーズ
ティン	テラフォーマーズ
三条加奈子	テラフォーマーズ
秋田奈々緒	テラフォーマーズ
ボルジギーン・ドルヂバーキ	テラフォーマーズ
蛭間一郎	テラフォーマーズ
ドナテロ・K・デイヴス	テラフォーマーズ
ミッシェル・K・デイヴス	テラフォーマーズ
劉翊武	テラフォーマーズ
爆致嵐	テラフォーマーズ
ヴィクトリア・ウッド	テラフォーマーズ
柳瀬川八重子	テラフォーマーズ
イワン・ペレペルキナ	テラフォーマーズ
アドルフ・ラインハルト	テラフォーマーズ
ジョセフ・G・ニュートン	テラフォーマーズ
エヴァ・フロスト	テラフォーマーズ
シーラ・レヴィット	テラフォーマーズ
シルヴェスター・アシモフ	テラフォーマーズ
ベニ	テンカイナイト
蜂須賀チュウキ	テンカイナイト
ブルータス	テンカイナイト
スライガー	テンカイナイト
鷲崎セイラン	テンカイナイト
ヴィリウス	テンカイナイト
アキラ	テンカイナイト
亀山トクサ	テンカイナイト
柴崎芦花	ディーふらぐ!
山田	ディーふらぐ!
風間堅次	ディーふらぐ!
神泉	ディーふらぐ!
境多摩	ディーふらぐ!
高崎	ディーふらぐ!
水上桜	ディーふらぐ!
高尾	ディーふらぐ!
烏山千歳	ディーふらぐ!
大沢南	ディーふらぐ!
明覚	ディーふらぐ!
長沼	ディーふらぐ!
室見	ディーふらぐ!
藤崎	ディーふらぐ!
子王八	ディーふらぐ!
小田原	ディーふらぐ!
登戸	ディーふらぐ!
福西	ディーふらぐ!
風間之江	ディーふらぐ!
篠崎	ディーふらぐ!
西永福子	ディーふらぐ!
竹沢	ディーふらぐ!
大濠	ディーふらぐ!
河原中	ディーふらぐ!
船堀	ディーふらぐ!
藤井	デス・パレード
二郎	デス・パレード
原田	デス・パレード
真智子	デス・パレード
島田	デス・パレード
クラヴィス	デス・パレード
五十嵐丸太	デッドマン・ワンダーランド
橙火花	デッドマン・ワンダーランド
剣ヶ峰凪	デッドマン・ワンダーランド
鷹見水名月	デッドマン・ワンダーランド
玉木常長	デッドマン・ワンダーランド
六路文堂	デッドマン・ワンダーランド
土門	デッドマン・ワンダーランド
鷹見羊	デッドマン・ワンダーランド
張	デッドマン・ワンダーランド
青陽	デッドマン・ワンダーランド
桃井	デッドマン・ワンダーランド
千地清正	デッドマン・ワンダーランド
東弦角	デッドマン・ワンダーランド
咲神トト	デッドマン・ワンダーランド
平和島静雄	デュラララ!!
狩沢絵理華	デュラララ!!
鯨木かさね	デュラララ!!
黒沼青葉	デュラララ!!
サイモン・ブレジネフ	デュラララ!!
澱切陣内	デュラララ!!
紀田正臣	デュラララ!!
六条千景	デュラララ!!
平和島幽	デュラララ!!
折原臨也	デュラララ!!
滝口亮	デュラララ!!
エゴール	デュラララ!!
写楽美影	デュラララ!!
張間美香	デュラララ!!
田中トム	デュラララ!!
三ヶ島沙樹	デュラララ!!
三好吉宗	デュラララ!!
泉井蘭	デュラララ!!
折原九瑠璃	デュラララ!!
赤林海月	デュラララ!!
四木春也	デュラララ!!
渡草三郎	デュラララ!!
青崎柊	デュラララ!!
粟楠茜	デュラララ!!
奈倉	デュラララ!!
エミリア	デュラララ!!
矢霧誠二	デュラララ!!
門田京平	デュラララ!!
園原杏里	デュラララ!!
竜ヶ峰帝人	デュラララ!!
矢霧波江	デュラララ!!
岸谷森厳	デュラララ!!
スローン	デュラララ!!
粟楠道元	デュラララ!!
贄川春奈	デュラララ!!
風本隆秋	デュラララ!!
遊馬崎ウォーカー	デュラララ!!
デニス	デュラララ!!
四十万博人	デュラララ!!
五十嵐千晶	デュラララ!!
折原舞流	デュラララ!!
岸谷新羅	デュラララ!!
葛原金之助	デュラララ!!
聖辺ルリ	デュラララ!!
ソムリエ	デンキ街の本屋さん
ひおたん	デンキ街の本屋さん
腐ガール	デンキ街の本屋さん
八舞夕弦	デート・ア・ライブ
崇宮真那	デート・ア・ライブ
五河士織	デート・ア・ライブ
園神凜緒	デート・ア・ライブ
殿町宏人	デート・ア・ライブ
村雨令音	デート・ア・ライブ
時崎狂三	デート・ア・ライブ
エリオット・ボールドウィン・ウッドマン	デート・ア・ライブ
岡峰珠恵	デート・ア・ライブ
エレン・ミラ・メイザース	デート・ア・ライブ
岡峰美紀恵	デート・ア・ライブ
ミルドレッド・F・藤村	デート・ア・ライブ
夜刀神十香	デート・ア・ライブ
日下部燎子	デート・ア・ライブ
神無月恭平	デート・ア・ライブ
塚本	デート・ア・ライブ
アンドリュー	デート・ア・ライブ
ジェシカ・ベイリー	デート・ア・ライブ
鳶一折紙	デート・ア・ライブ
五河琴里	デート・ア・ライブ
真城ミズキ	トライブクルクル
直太朗	トライブクルクル
三郎	トライブクルクル
音咲カノン	トライブクルクル
涌井	トライブクルクル
メイベル	トライブクルクル
サトシ	トライブクルクル
木場美琴	トリアージX
小川真	トリアージX
柩小夜	トリアージX
狭霧友子	トリアージX
梨田織葉	トリアージX
三神嵐	トリアージX
剣光姫	トリアージX
茂松	トリコ
雪丸	トリコ
フローゼ	トリコ
ゾンゲ	トリコ
よっち	トリコ
大竹	トリコ
タッチーノ・カワゴエ	トリコ
鉄平	トリコ
アルファロ	トリコ
千流	トリコ
トリコ	トリコ
グリンパーチ	トリコ
節乃	トリコ
三虎	トリコ
ギリム	トリコ
ボギーウッズ	トリコ
マンサム	トリコ
クルッポー	トリコ
愛丸	トリコ
オーバン	トリコ
ジョア	トリコ
サフラ	トリコ
ジャンピン	トリコ
原	トリコ
ウーメン梅田	トリコ
小松	トリコ
ライブベアラー	トリコ
コプリ子	トリコ
フォン・ド・ボーノ	トリコ
ペック	トリコ
トミーロッド	トリコ
滝丸	トリコ
月丸	トリコ
グル	トリコ
珍鎮々	トリコ
風間レヴィ	トリニティセブン
倉田ユイ	トリニティセブン
イリア	トリニティセブン
山奈ミラ	トリニティセブン
神無月アリン	トリニティセブン
春日聖	トリニティセブン
春日アラタ	トリニティセブン
不動アキオ	トリニティセブン
ナタリア	トレインヒーロー
崔亦菲	トータル・イクリプス
ヴァレリオ・ジアコーザ	トータル・イクリプス
ステラ・ブレーメル	トータル・イクリプス
タリサ・マナンダル	トータル・イクリプス
三村	ドキドキ!プリキュア
グーラ	ドキドキ!プリキュア
ラケル	ドキドキ!プリキュア
相田健太郎	ドキドキ!プリキュア
十条博士	ドキドキ!プリキュア
五星麗奈	ドキドキ!プリキュア
坂東宗吉	ドキドキ!プリキュア
四葉一郎	ドキドキ!プリキュア
美智子	ドキドキ!プリキュア
かるたクイーン	ドキドキ!プリキュア
城戸	ドキドキ!プリキュア
円茉里	ドキドキ!プリキュア
角野秋	ドキドキ!プリキュア
マーモ	ドキドキ!プリキュア
菱川亮子	ドキドキ!プリキュア
リーヴァ	ドキドキ!プリキュア
イーラ	ドキドキ!プリキュア
百田	ドキドキ!プリキュア
京田	ドキドキ!プリキュア
メラン	ドキドキ!プリキュア
八嶋	ドキドキ!プリキュア
早乙女純	ドキドキ!プリキュア
二階堂	ドキドキ!プリキュア
菱川悠蔵	ドキドキ!プリキュア
相田あゆみ	ドキドキ!プリキュア
如月竜司	ドラゴンクライシス!
オニキス	ドラゴンクライシス!
江藤実咲	ドラゴンクライシス!
甲斐	ドラゴンクライシス!
七尾英理子	ドラゴンクライシス!
リーガック	ドラゴンコレクション
ユナ	ドラゴンコレクション
カーヤ	ドルアーガの塔_〜the_Sword_of_URUK〜
ミラーナイト	ドルアーガの塔_〜the_Sword_of_URUK〜
サキュバス	ドルアーガの塔_〜the_Sword_of_URUK〜
メルト	ドルアーガの塔_〜the_Sword_of_URUK〜
オロ	ドルアーガの塔_〜the_Sword_of_URUK〜
クーパ	ドルアーガの塔_〜the_Sword_of_URUK〜
アーメイ	ドルアーガの塔_〜the_Sword_of_URUK〜
チョコラ	ドン・ドラキュラ
ベール＝ゼファー	ナイトウィザード_The_ANIMATION
ロンギヌス	ナイトウィザード_The_ANIMATION
アンゼロット	ナイトウィザード_The_ANIMATION
緋室灯	ナイトウィザード_The_ANIMATION
赤羽くれは	ナイトウィザード_The_ANIMATION
ツトム	ナンダカベロニカ
桑野みゆき	ナースエンジェルりりかSOS
宇崎星夜	ナースエンジェルりりかSOS
森谷りりか	ナースエンジェルりりかSOS
ブロス	ナースエンジェルりりかSOS
マルル	ナースエンジェルりりかSOS
山崎	ナースエンジェルりりかSOS
宮本るり	ニセコイ
彩風涼	ニセコイ
小野寺春	ニセコイ
舞子集	ニセコイ
ポーラ・マッコイ	ニセコイ
小野寺菜々子	ニセコイ
一条楽	ニセコイ
鶫誠士郎	ニセコイ
奏倉羽	ニセコイ
桐崎華	ニセコイ
ニャンダーかれん	ニャニがニャンだー_ニャンダーかめん
ギンコ	ニャニがニャンだー_ニャンダーかめん
ニャンタ	ニャニがニャンだー_ニャンダーかめん
リリコ	ニャニがニャンだー_ニャンダーかめん
モグスター	ニャニがニャンだー_ニャンダーかめん
マティアス	ネオ_アンジェリーク_Abyss
エルヴィン	ネオ_アンジェリーク_Abyss
ロシュ	ネオ_アンジェリーク_Abyss
ニクス	ネオ_アンジェリーク_Abyss
アーノルド	ネクスト戦記EHRGEIZ
ゴード	ネクスト戦記EHRGEIZ
バルザック	ネクスト戦記EHRGEIZ
キャメル	ネクスト戦記EHRGEIZ
進藤守	ネットゴーストPIPOPA
祖父江ひかる	ネットゴーストPIPOPA
真知子	ネットゴーストPIPOPA
東海林	ネットゴーストPIPOPA
雪谷花梨	ネットゴーストPIPOPA
松下シュウゾウ	ネットゴーストPIPOPA
サヤカ・エレンコワ	ネットゴーストPIPOPA
プリリン	ネットゴーストPIPOPA
ルーアン	ネットゴーストPIPOPA
上乃木ハルカ	ノエイン_もうひとりの君へ
コサギ	ノエイン_もうひとりの君へ
後藤ユウ	ノエイン_もうひとりの君へ
藤原イサミ	ノエイン_もうひとりの君へ
浅尾かおる	ノブナガン
ガウディ	ノブナガン
壱与	ノブナガン
ジェス・ベッカム	ノブナガン
戴宗	ノブナガン
フローレンス・ナイチンゲール	ノブナガン
オダ・ノブナガ	ノブナガ・ザ・フール
ガイウス・ユリウス・カエサル	ノブナガ・ザ・フール
レオナルド・ダ・ヴィンチ	ノブナガ・ザ・フール
ウエスギ・ケンシン	ノブナガ・ザ・フール
アレクサンダー	ノブナガ・ザ・フール
チェーザレ・ボルジア	ノブナガ・ザ・フール
ツェペッシュ・ビアンキ	ノブナガ・ザ・フール
タケダ・シンゲン	ノブナガ・ザ・フール
ツェペッシュ・ネル	ノブナガ・ザ・フール
トヨトミ・ヒデヨシ	ノブナガ・ザ・フール
オダ・ノブカツ	ノブナガ・ザ・フール
藍巴	ノラガミ
陸巴	ノラガミ
藤崎浩人	ノラガミ
雪音	ノラガミ
紹巴	ノラガミ
山下晶	ノラガミ
睦美	ノラガミ
壱岐ひより	ノラガミ
囷巴	ノラガミ
テト	ノーゲーム・ノーライフ
ジブリール	ノーゲーム・ノーライフ
初瀬いづな	ノーゲーム・ノーライフ
クラミー・ツェル	ノーゲーム・ノーライフ
初瀬いの	ノーゲーム・ノーライフ
フィール・ニルヴァレン	ノーゲーム・ノーライフ
ステファニー・ドーラ	ノーゲーム・ノーライフ
東峰旭	ハイキュー!!
猫又育史	ハイキュー!!
浅虫快人	ハイキュー!!
森達也	ハイキュー!!
赤葦京治	ハイキュー!!
二岐丈春	ハイキュー!!
岩泉一	ハイキュー!!
古牧譲	ハイキュー!!
影山飛雄	ハイキュー!!
小原豊	ハイキュー!!
矢巾秀	ハイキュー!!
森行成	ハイキュー!!
武田一鉄	ハイキュー!!
笹谷武仁	ハイキュー!!
田中冴子	ハイキュー!!
泉行高	ハイキュー!!
小見春樹	ハイキュー!!
京谷賢太郎	ハイキュー!!
烏養繋心	ハイキュー!!
月島蛍	ハイキュー!!
木下久志	ハイキュー!!
鷲尾辰生	ハイキュー!!
直井学	ハイキュー!!
中島愛	ハイキュー!!
孤爪研磨	ハイキュー!!
百沢雄大	ハイキュー!!
木葉秋紀	ハイキュー!!
道宮結	ハイキュー!!
沼尻凛太郎	ハイキュー!!
谷地仁花	ハイキュー!!
清	ハイキュー!!
山口忠	ハイキュー!!
西谷夕	ハイキュー!!
嶋田誠	ハイキュー!!
入畑伸照	ハイキュー!!
中島猛	ハイキュー!!
土湯新	ハイキュー!!
牛島若利	ハイキュー!!
黒尾鉄朗	ハイキュー!!
三咲華	ハイキュー!!
菅原孝支	ハイキュー!!
渡親治	ハイキュー!!
猿杙大和	ハイキュー!!
松川一静	ハイキュー!!
福永招平	ハイキュー!!
花巻貴大	ハイキュー!!
母畑和馬	ハイキュー!!
関向幸治	ハイキュー!!
及川徹	ハイキュー!!
金田一勇太郎	ハイキュー!!
秋宮昇	ハイキュー!!
池尻隼人	ハイキュー!!
澤村大地	ハイキュー!!
滑津舞	ハイキュー!!
成田一仁	ハイキュー!!
松島剛	ハイキュー!!
尾長渉	ハイキュー!!
作並浩輔	ハイキュー!!
東山勝道	ハイキュー!!
国見英	ハイキュー!!
夜久衛輔	ハイキュー!!
灰羽リエーフ	ハイキュー!!
清水潔子	ハイキュー!!
日向翔陽	ハイキュー!!
照島遊児	ハイキュー!!
田中龍之介	ハイキュー!!
月島明光	ハイキュー!!
滝ノ上祐輔	ハイキュー!!
木兎光太郎	ハイキュー!!
内沢英紀	ハイキュー!!
溝口貞幸	ハイキュー!!
物星大	ハイスクール!奇面組
大間仁	ハイスクール!奇面組
骨岸無造	ハイスクール!奇面組
札仁巣牌子	ハイスクール!奇面組
うしろゆびさされ組	ハイスクール!奇面組
匙元士郎	ハイスクールD×D
オーフィス	ハイスクールD×D
ライザー・フェニックス	ハイスクールD×D
ユーベルーナ	ハイスクールD×D
ドーナシーク	ハイスクールD×D
黒歌	ハイスクールD×D
ヴァーリ・ルシファー	ハイスクールD×D
セラフォルー・レヴィアタン	ハイスクールD×D
レイナーレ	ハイスクールD×D
美加	ハイスクールD×D
ミッテルト	ハイスクールD×D
木場祐斗	ハイスクールD×D
桐生藍華	ハイスクールD×D
アーサー・ペンドラゴン	ハイスクールD×D
森沢	ハイスクールD×D
カラワーナ	ハイスクールD×D
元浜	ハイスクールD×D
ソーナ・シトリー	ハイスクールD×D
アーシア・アルジェント	ハイスクールD×D
ギャスパー・ヴラディ	ハイスクールD×D
サイラオーグ・バアル	ハイスクールD×D
ヴェネラナ・グレモリー	ハイスクールD×D
西浦	ハイスクールD×D
ロスヴァイセ	ハイスクールD×D
ミルたん	ハイスクールD×D
月影明子	ハイスクールミステリー学園七不思議
タッチ	ハッスルパンチ
西御門多美	ハナヤマタ
常盤真智	ハナヤマタ
笹目ヤヤ	ハナヤマタ
ハナ・N・フォンテーンスタンド	ハナヤマタ
大船勝	ハナヤマタ
常盤沙里	ハナヤマタ
吉田よし子	ハニ太郎です。
相楽誠司	ハピネスチャージプリキュア!
大森ようこ	ハピネスチャージプリキュア!
大森あい	ハピネスチャージプリキュア!
愛乃かおり	ハピネスチャージプリキュア!
大森たけお	ハピネスチャージプリキュア!
キュアフォーチュン	ハピネスチャージプリキュア!
高野れい	ハピネスチャージプリキュア!
卓真	ハピネスチャージプリキュア!
椎名えれな	ハピネスチャージプリキュア!
古田かな	ハピネスチャージプリキュア!
トウマ	ハピネスチャージプリキュア!
和泉	ハピネスチャージプリキュア!
生瀬	ハピネスチャージプリキュア!
幸代	ハピネスチャージプリキュア!
相楽真央	ハピネスチャージプリキュア!
愛乃勝	ハピネスチャージプリキュア!
石神りん	ハピネスチャージプリキュア!
山崎健太	ハピネスチャージプリキュア!
かずみ	ハピネスチャージプリキュア!
優子	ハムスター倶楽部
真弓	ハムスター倶楽部
西沢一樹	ハヤテのごとく!
鷺ノ宮銀華	ハヤテのごとく!
東宮康太郎	ハヤテのごとく!
鷺ノ宮伊澄	ハヤテのごとく!
桂雪路	ハヤテのごとく!
剣野カユラ	ハヤテのごとく!
三千院紫子	ハヤテのごとく!
西沢歩	ハヤテのごとく!
霞愛歌	ハヤテのごとく!
渡良瀬ミカゲ	ハヤテのごとく!
マヤ	ハヤテのごとく!
葛葉キリカ	ハヤテのごとく!
瀬川泉	ハヤテのごとく!
柏木	ハヤテのごとく!
アルマゲドン	ハヤテのごとく!
天王州アテネ	ハヤテのごとく!
牧村志織	ハヤテのごとく!
姫神茜	ハヤテのごとく!
春風千桜	ハヤテのごとく!
橘ワタル	ハヤテのごとく!
瀬川虎鉄	ハヤテのごとく!
マックロー	ハローキティ_りんごの森のファンタジー
トレーシー	ハローキティ_りんごの森のファンタジー
ミミィ	ハローキティ_りんごの森のファンタジー
アクロ	ハローキティ_りんごの森のファンタジー
柴田剛	ハングリーハート_WILD_STRIKER
古木	ハングリーハート_WILD_STRIKER
中山雅史	ハングリーハート_WILD_STRIKER
佐古俊也	ハングリーハート_WILD_STRIKER
藤沢かりん	ハングリーハート_WILD_STRIKER
戸田邦和	ハングリーハート_WILD_STRIKER
政子	ハーイあっこです
ヨシコ	ハーイあっこです
ヒナコ	ハーイあっこです
来海さくら	ハートキャッチプリキュア!
佐久間としこ	ハートキャッチプリキュア!
シプレ	ハートキャッチプリキュア!
謎の青年	ハートキャッチプリキュア!
サソリーナ	ハートキャッチプリキュア!
高岸あずさ	ハートキャッチプリキュア!
明堂院厳太郎	ハートキャッチプリキュア!
杉山ごう	ハートキャッチプリキュア!
花咲空	ハートキャッチプリキュア!
堀内アキ	ハートキャッチプリキュア!
月影春菜	ハートキャッチプリキュア!
志久ななみ	ハートキャッチプリキュア!
番ケンジ	ハートキャッチプリキュア!
花咲みずき	ハートキャッチプリキュア!
鶴崎	ハートキャッチプリキュア!
才谷秀雄	ハートキャッチプリキュア!
来海ももか	ハートキャッチプリキュア!
デューン	ハートキャッチプリキュア!
ダークプリキュア	ハートキャッチプリキュア!
ハヤト	ハートキャッチプリキュア!
沢井なおみ	ハートキャッチプリキュア!
花咲陽一	ハートキャッチプリキュア!
キュアフラワー	ハートキャッチプリキュア!
水島アヤ	ハートキャッチプリキュア!
小笠原まお	ハートキャッチプリキュア!
明堂院さつき	ハートキャッチプリキュア!
来海流之助	ハートキャッチプリキュア!
キュアサンシャイン	ハートキャッチプリキュア!
上島さやか	ハートキャッチプリキュア!
柴田リサ	ハートキャッチプリキュア!
キュアムーンライト	ハートキャッチプリキュア!
三浦あきら	ハートキャッチプリキュア!
原野正広	ハートキャッチプリキュア!
黒田るみこ	ハートキャッチプリキュア!
露木かりん	ハートキャッチプリキュア!
小畑	ハートキャッチプリキュア!
酒井まさと	ハートキャッチプリキュア!
明堂院つばき	ハートキャッチプリキュア!
佐藤一二三	ハートキャッチプリキュア!
キュアマリン	ハートキャッチプリキュア!
クモジャキー	ハートキャッチプリキュア!
コブラージャ	ハートキャッチプリキュア!
多田かなえ	ハートキャッチプリキュア!
中野みつる	ハートキャッチプリキュア!
コフレ	ハートキャッチプリキュア!
竹中	バカとテストと召喚獣
霧島翔子	バカとテストと召喚獣
木下優子	バカとテストと召喚獣
須川亮	バカとテストと召喚獣
吉井明久	バカとテストと召喚獣
小山友香	バカとテストと召喚獣
坂本雄二	バカとテストと召喚獣
久保利光	バカとテストと召喚獣
大島武	バカとテストと召喚獣
島田葉月	バカとテストと召喚獣
木下秀吉	バカとテストと召喚獣
高橋洋子	バカとテストと召喚獣
中林宏美	バカとテストと召喚獣
工藤愛子	バカとテストと召喚獣
清水美春	バカとテストと召喚獣
佐藤美穂	バカとテストと召喚獣
吉井玲	バカとテストと召喚獣
中路	バクマン。
森屋秀一	バクマン。
港浦吾郎	バクマン。
服部哲	バクマン。
白鳥シュン	バクマン。
茨木	バクマン。
矢作	バクマン。
瓶子吉久	バクマン。
服部雄二郎	バクマン。
加藤奈津実	バクマン。
地虫十兵衛	バジリスク_〜甲賀忍法帖〜
お胡夷	バジリスク_〜甲賀忍法帖〜
蓑念鬼	バジリスク_〜甲賀忍法帖〜
如月左衛門	バジリスク_〜甲賀忍法帖〜
朱絹	バジリスク_〜甲賀忍法帖〜
筑摩小四郎	バジリスク_〜甲賀忍法帖〜
竹千代	バジリスク_〜甲賀忍法帖〜
セラ・D・ミランダ	バスカッシュ!
ミユキ・アユカワ	バスカッシュ!
はるか・グレイシア	バスカッシュ!
ヴィオレット	バスカッシュ!
クローリー	バスカッシュ!
スパンキー	バスカッシュ!
ビゾン・ジェラフィル	バディ・コンプレックス
アネッサ・ロセッティ	バディ・コンプレックス
エルヴィラ・ヒル	バディ・コンプレックス
渡瀬青葉	バディ・コンプレックス
リチャードソン	バディ・コンプレックス
隼鷹・フィオナ・ウェインバーグ	バディ・コンプレックス
レーネ・クラインベック	バディ・コンプレックス
アルフリード・ガラント	バディ・コンプレックス
カガン	バディ・コンプレックス
ヤール・ドゥラン	バディ・コンプレックス
マルガレタ・オキーフ	バディ・コンプレックス
ラーシャ・ハッカライネン	バディ・コンプレックス
奈須まゆか	バディ・コンプレックス
隼鷹・ディオ・ウェインバーグ	バディ・コンプレックス
フロム・ヴァンタレイ	バディ・コンプレックス
倉光源吾	バディ・コンプレックス
タルジム・ヴァシリー	バディ・コンプレックス
リー・コンラッド	バディ・コンプレックス
スハルト	バディ・コンプレックス
ヴィルヘルム・ハーン	バディ・コンプレックス
クリス・クリストファ	バトルアスリーテス_大運動会
御堂巴	バトルアスリーテス_大運動会
エリック・ロバーツ	バトルアスリーテス_大運動会
ガルドス・ランダル	バトルスピリッツ_ソードアイズ
ゴーディ・ダーイン	バトルスピリッツ_ソードアイズ
キザクラ・ククリ	バトルスピリッツ_ソードアイズ
ハクア・エストック	バトルスピリッツ_ソードアイズ
アマレロ・ベルジェ	バトルスピリッツ_ソードアイズ
ブラウ・バルム	バトルスピリッツ_ソードアイズ
ブリンガー	バトルスピリッツ_ソードアイズ
ソラ・リュウヨウ	バトルスピリッツ_ソードアイズ
ガスパール	バトルスピリッツ_ブレイヴ
ユース・グリンホルン	バトルスピリッツ_ブレイヴ
メムノン	バトルスピリッツ_ブレイヴ
フローラ・パフューム	バトルスピリッツ_ブレイヴ
月光のバローネ	バトルスピリッツ_ブレイヴ
ゾルダー・グレイヴ	バトルスピリッツ_ブレイヴ
暗闇のザジ	バトルスピリッツ_ブレイヴ
ベネルド	バトルスピリッツ_ブレイヴ
ギルファム	バトルスピリッツ_ブレイヴ
兵堂剣蔵	バトルスピリッツ_ブレイヴ
クラッキー・レイ	バトルスピリッツ_ブレイヴ
プリム・マキーナ	バトルスピリッツ_ブレイヴ
硯秀斗	バトルスピリッツ_ブレイヴ
ステラ・コラベリシチコフ	バトルスピリッツ_ブレイヴ
ランデル	バトルスピリッツ_少年激覇ダン
百瀬華実	バトルスピリッツ_少年激覇ダン
田中一郎	バトルスピリッツ_少年激覇ダン
リボルバー	バトルスピリッツ_少年激覇ダン
セルジュ	バトルスピリッツ_少年激覇ダン
パンテーラ	バトルスピリッツ_少年激覇ダン
ゴーダ	バトルスピリッツ_少年激覇ダン
マギサ	バトルスピリッツ_少年激覇ダン
ナミー	バトルスピリッツ_少年激覇ダン
チュー	バトルスピリッツ_少年激覇ダン
ズングリー	バトルスピリッツ_少年激覇ダン
お京	バトルスピリッツ_少年突破バシン
マッチョ	バトルスピリッツ_少年突破バシン
マイサンシャイン	バトルスピリッツ_少年突破バシン
ク条キューサク	バトルスピリッツ_少年突破バシン
マイケル・エリオット	バトルスピリッツ_少年突破バシン
拓馬	バトルスピリッツ_烈火魂
白銀謙信	バトルスピリッツ_烈火魂
黒田環奈	バトルスピリッツ_烈火魂
真白藤吉郎	バトルスピリッツ_烈火魂
馬神トッパ	バトルスピリッツ_烈火魂
紫堂信玄	バトルスピリッツ_烈火魂
紫鬼神蘭丸	バトルスピリッツ_烈火魂
炎利家	バトルスピリッツ_烈火魂
天魔信長	バトルスピリッツ_烈火魂
暁佐助	バトルスピリッツ_烈火魂
美鳥山阿国	バトルスピリッツ_烈火魂
宝緑院兼続	バトルスピリッツ_烈火魂
棚志テガマル	バトルスピリッツ_覇王
芹沢イサミ	バトルスピリッツ_覇王
レナード・ウィリアム・アードレイ	バトルスピリッツ_覇王
大泉マナブ	バトルスピリッツ_覇王
アントニー・スタルク	バトルスピリッツ_覇王
巽コウタ	バトルスピリッツ_覇王
井上裕衣	バトルスピリッツ_覇王
巽キマリ	バトルスピリッツ_覇王
大泉カタル	バトルスピリッツ_覇王
宮崎都	バンブーブレード
桑原鞘子	バンブーブレード
千葉紀梨乃	バンブーブレード
東聡莉	バンブーブレード
石田虎侍	バンブーブレード
川添珠姫	バンブーブレード
ダンカン	パタパタ飛行船の冒険
サシャ	パタパタ飛行船の冒険
バンチ	パタパタ飛行船の冒険
佐原よし子	パパのいうことを聞きなさい!
小鳥遊祐理	パパのいうことを聞きなさい!
小鳥遊ひな	パパのいうことを聞きなさい!
小鳥遊信吾	パパのいうことを聞きなさい!
小鳥遊美羽	パパのいうことを聞きなさい!
小鳥遊空	パパのいうことを聞きなさい!
仁村浩一	パパのいうことを聞きなさい!
織田莱香	パパのいうことを聞きなさい!
丸子	パラソルヘンべえ
シュルツ	パンプキン・シザーズ
アリス・L・マルヴィン	パンプキン・シザーズ
ロゼッタ	パンプキン・シザーズ
マーチス	パンプキン・シザーズ
ランデル・オーランド	パンプキン・シザーズ
JACK	パンプキン・シザーズ
柿本	ヒカルの碁
和谷義高	ヒカルの碁
緒方精次	ヒカルの碁
小池仁志	ヒカルの碁
小島	ヒカルの碁
藤原佐為	ヒカルの碁
周平	ヒカルの碁
篠田	ヒカルの碁
塔矢行洋	ヒカルの碁
美和	ヒカルの碁
楊海	ヒカルの碁
塔矢アキラ	ヒカルの碁
河合	ヒカルの碁
筒井公宏	ヒカルの碁
一柳	ヒカルの碁
倉田厚	ヒカルの碁
洪秀英	ヒカルの碁
伊角慎一郎	ヒカルの碁
白川道夫	ヒカルの碁
尹	ヒカルの碁
久野	ヒカルの碁
奥村	ヒカルの碁
津田久美子	ヒカルの碁
金子正子	ヒカルの碁
森山	ヒカルの碁
藤崎あかり	ヒカルの碁
村上信一	ヒカルの碁
天野	ヒカルの碁
福井雄太	ヒカルの碁
社清春	ヒカルの碁
奈瀬明日美	ヒカルの碁
三谷祐輝	ヒカルの碁
北島	ヒカルの碁
早乙女雀	ヒャッコ
幕之内潮	ヒャッコ
蕾家祈	ヒャッコ
風茉莉冬馬	ヒャッコ
杏藤子々	ヒャッコ
能乃村歩巳	ヒャッコ
大場湊兎	ヒャッコ
伊井塚龍姫	ヒャッコ
ノリエガ	ヒートガイジェイ
マウロ	ヒートガイジェイ
秋内ハナ	ヒーローバンク
金形鉄之助	ヒーローバンク
天野ナガレ	ヒーローバンク
デボラ貴崎	ヒーローバンク
桜田セキト	ヒーローバンク
龍里千	ヒーローバンク
海鳴一心	ヒーローバンク
パラディン	ビキニ・ウォリアーズ
ヴァルキリー	ビキニ・ウォリアーズ
シネス皇帝	ビックリマン2000
愛助コーラル	ビックリマン2000
福陽気妃	ビックリマン2000
天助ポーチ	ビックリマン2000
ヘッドロココ	ビックリマン2000
インスパイア	ビデオ戦士レザリオン
一色あかね	ビビッドレッド・オペレーション
二葉あおい	ビビッドレッド・オペレーション
一色もも	ビビッドレッド・オペレーション
黒騎れい	ビビッドレッド・オペレーション
天城みずは	ビビッドレッド・オペレーション
三枝わかば	ビビッドレッド・オペレーション
一色健次郎	ビビッドレッド・オペレーション
一色ましろ	ビビッドレッド・オペレーション
紫条悠里	ビビッドレッド・オペレーション
キャプテンブルー	ビューティフル_ジョー
スプロケット	ビューティフル_ジョー
ファルカン	ビーストサーガ
レパーミント	ビーストサーガ
ライズ	ビーストサーガ
ビバップ	ビーストサーガ
ダッカー	ビーストサーガ
バンダ	ビーストサーガ
オーガ	ビーストサーガ
マリウス	ピグマリオ
クルト	ピグマリオ
やまもと	ピポパポパトルくん
孔文革	ピンポン_THE_ANIMATION
風間竜一	ピンポン_THE_ANIMATION
月本誠	ピンポン_THE_ANIMATION
佐久間学	ピンポン_THE_ANIMATION
フック船長	ピーターパンの冒険
タイガーリリー	ピーターパンの冒険
ウェンディ・モイラー・アンジェラ・ダーリング	ピーターパンの冒険
スターキー	ピーターパンの冒険
ラスカル	ピーターパンの冒険
ティンカー・ベル	ピーターパンの冒険
ピーター・パン	ピーターパンの冒険
アレスタ・ブランケット	ファイト一発!_充電ちゃん!!
りん子	ファイト一発!_充電ちゃん!!
ロナ・エルモ	ファイト一発!_充電ちゃん!!
クラン・シャント	ファイト一発!_充電ちゃん!!
近江はこね	ファイト一発!_充電ちゃん!!
逆之上ギャモン	ファイ・ブレイン_神のパズル
メランコリィ	ファイ・ブレイン_神のパズル
ヘルベルト・ミューラー	ファイ・ブレイン_神のパズル
ピノクル	ファイ・ブレイン_神のパズル
水谷アイリ	ファイ・ブレイン_神のパズル
フリーセル	ファイ・ブレイン_神のパズル
アナ・グラム	ファイ・ブレイン_神のパズル
逆之上ミハル	ファイ・ブレイン_神のパズル
ジーニアス奥寺	ファイ・ブレイン_神のパズル
姫川エレナ	ファイ・ブレイン_神のパズル
イヴ・グラム	ファイ・ブレイン_神のパズル
鬼の手姫	ファイ・ブレイン_神のパズル
千枝乃タマキ	ファイ・ブレイン_神のパズル
ダウト	ファイ・ブレイン_神のパズル
レイツェル	ファイ・ブレイン_神のパズル
フンガ	ファイ・ブレイン_神のパズル
武田ナオキ	ファイ・ブレイン_神のパズル
ミゼルカ	ファイ・ブレイン_神のパズル
デコラシオン	ファンタジスタドール
レンブラント	ファンタジスタドール
ヴィヴィ	ファンタジスタドール
三笠凛人	ファンタジスタドール
戸取かがみ	ファンタジスタドール
羽月まない	ファンタジスタドール
清水潔	ファンタジスタドール
鵜野みこ	ファンタジスタドール
しいの実	ファンタジスタドール
清正小町	ファンタジスタドール
鵜野みこと	ファンタジスタドール
ヒースマ	ファンタジックチルドレン
デュマ	ファンタジックチルドレン
コンラート	ファンタジックチルドレン
ソレト	ファンタジックチルドレン
ヘルガ	ファンタジックチルドレン
ハスモダイ	ファンタジックチルドレン
シャルロット	ファーブル先生は名探偵
ディオン	ファーブル先生は名探偵
東孝	フォトカノ
成田瑠宇	フォトカノ
九堂博道	フォトカノ
紅林かつみ	フォトカノ
大谷桃子	フォトカノ
内田有子	フォトカノ
前田果音	フォトカノ
ひでまる	フォルツァ!ひでまる
ラルス	フォルツァ!ひでまる
ペレス	フォルツァ!ひでまる
ステラ・ワトソン	フューチャーカード_バディファイト
祠堂孫六	フューチャーカード_バディファイト
滝原剣	フューチャーカード_バディファイト
ディミオスソード・ドラゴン	フューチャーカード_バディファイト
宇木くぐる	フューチャーカード_バディファイト
黒岳テツヤ	フューチャーカード_バディファイト
霧雨正雪	フューチャーカード_バディファイト
氷竜キリ	フューチャーカード_バディファイト
包蔵禍心闇狐	フューチャーカード_バディファイト
如月斬夜	フューチャーカード_バディファイト
未門涼実	フューチャーカード_バディファイト
龍炎寺タスク	フューチャーカード_バディファイト
メデューサ	フューチャーカード_バディファイト
山崎ダビデ	フューチャーカード_バディファイト
ソフィア・サハロフ	フューチャーカード_バディファイト
毛村	フューチャーカード_バディファイト
富士宮風音	フューチャーカード_バディファイト
手札の君レア麿	フューチャーカード_バディファイト
臥炎キョウヤ	フューチャーカード_バディファイト
轟鬼ゲンマ	フューチャーカード_バディファイト
金蛇秀水	フューチャーカード_バディファイト
オカダ・カズチカ	フューチャーカード_バディファイト
未門花子	フューチャーカード_バディファイト
グレンデル	フューチャーカード_バディファイト
奈々菜パル子	フューチャーカード_バディファイト
天野鈴鈴羽	フューチャーカード_バディファイト
未門隆	フューチャーカード_バディファイト
カードバーン	フューチャーカード_バディファイト
迅雷騎士団ハルバード・ドラゴン	フューチャーカード_バディファイト
大盛爆	フューチャーカード_バディファイト
虎堂ノボル	フューチャーカード_バディファイト
真間雁メグミ	フューチャーカード_バディファイト
禍津ジン	フューチャーカード_バディファイト
未門陽太	フューチャーカード_バディファイト
ブレイドウイングフェニックス	フューチャーカード_バディファイト
如月暁	フューチャーカード_バディファイト
風間信二	フルメタル・パニック!
アンドレイ・セルゲイヴィッチ・カリーニン	フルメタル・パニック!
レナード・テスタロッサ	フルメタル・パニック!
ブライアント	フルメタル・パニック!
セイナ	フルメタル・パニック!
常盤恭子	フルメタル・パニック!
大貫善治	フルメタル・パニック!
ゲイツ	フルメタル・パニック!
リチャード・ヘンリー・マデューカス	フルメタル・パニック!
ダーナ	フルメタル・パニック!
鷲尾	フルメタル・パニック!
美樹原蓮	フルメタル・パニック!
椿一成	フルメタル・パニック!
植草	フルメタル・パニック!
佐伯恵那	フルメタル・パニック!
藤咲	フルメタル・パニック!
稲葉瑞樹	フルメタル・パニック!
草摩慊人	フルーツバスケット
草摩潑春	フルーツバスケット
草摩楽羅	フルーツバスケット
花島恵	フルーツバスケット
本田今日子	フルーツバスケット
満	フルーツバスケット
本田透	フルーツバスケット
草摩紫呉	フルーツバスケット
草摩杞紗	フルーツバスケット
皆川素子	フルーツバスケット
草摩夾	フルーツバスケット
草摩燈路	フルーツバスケット
草摩紅葉	フルーツバスケット
倉前美音	フルーツバスケット
倉伎真知	フルーツバスケット
知念大輔	フレッシュプリキュア!
山吹正	フレッシュプリキュア!
山吹尚子	フレッシュプリキュア!
蒼乃レミ	フレッシュプリキュア!
千香	フレッシュプリキュア!
ジェフリー王子	フレッシュプリキュア!
キュアパッション	フレッシュプリキュア!
ノーザ	フレッシュプリキュア!
桃園圭太郎	フレッシュプリキュア!
桃園源吉	フレッシュプリキュア!
アズキーナ	フレッシュプリキュア!
キュアベリー	フレッシュプリキュア!
沢裕喜	フレッシュプリキュア!
御子柴健人	フレッシュプリキュア!
エレア	ブラスレイター
スノウ	ブラスレイター
ミュラー	ブラスレイター
シズ	ブラック★ロックシューター
小鳥遊ヨミ	ブラック★ロックシューター
ナフェ	ブラック★ロックシューター
出灰カガリ	ブラック★ロックシューター
ヒロ	ブラック★ロックシューター
小幡アラタ	ブラック★ロックシューター
WRS	ブラック★ロックシューター
マズマ	ブラック★ロックシューター
納野サヤ	ブラック★ロックシューター
黒衣マト	ブラック★ロックシューター
神足ユウ	ブラック★ロックシューター
白拍子泰彦	ブラック・ジャック
手塚	ブラック・ジャック
琵琶丸	ブラック・ジャック
古和	ブラック・ジャック
伊東	ブラック・ジャック
ロミ	ブラック・ジャック
哲	ブラック・ジャック
和登	ブラック・ジャック21
蒼龍	ブラック・ジャック21
シュタイン博士	ブラック・ジャック21
本間丈太郎	ブラック・ジャック21
写楽	ブラック・ジャック21
西川史子	ブラック・ジャック21
松崎	ブラック・ブレット
片桐玉樹	ブラック・ブレット
蛭子小比奈	ブラック・ブレット
エイン・ランド	ブラック・ブレット
聖天子	ブラック・ブレット
薙沢彰磨	ブラック・ブレット
壬生朝霞	ブラック・ブレット
布施翠	ブラック・ブレット
ティナ・スプラウト	ブラック・ブレット
藍原延珠	ブラック・ブレット
千寿夏世	ブラック・ブレット
天童木更	ブラック・ブレット
片桐弓月	ブラック・ブレット
我堂長政	ブラック・ブレット
蛭子影胤	ブラック・ブレット
室戸菫	ブラック・ブレット
司馬未織	ブラック・ブレット
豆次郎	ブラッドラッド
ウルフダディ	ブラッドラッド
ブラッド・チャーリー・スタズ	ブラッドラッド
ミミック吉田	ブラッドラッド
ボルキュス・デュッセンルドルフ	ブレイク_ブレイド
バルド・ジ・アラン・アルヴァトロス	ブレイク_ブレイド
ゼス	ブレイク_ブレイド
ジルグ・ジ・レド・レ・アルヴァトロス	ブレイク_ブレイド
ホズル	ブレイク_ブレイド
ニーナケラ・ドルネイ	ブレイク_ブレイド
クレオ・サーブラフ	ブレイク_ブレイド
ロギン・ジー・ガルフ・エンサンス	ブレイク_ブレイド
ナイル・ストライズ	ブレイク_ブレイド
ナルヴィ・ストライズ	ブレイク_ブレイド
ジン・ハズキ	ブレイドアンドソウル
ジン・ヴァレル	ブレイドアンドソウル
エル・カレン	ブレイドアンドソウル
ヒギンズ・サス	ブレンパワード
カナン・ギモス	ブレンパワード
桑原	ブレンパワード
ナッキィ・ガイズ	ブレンパワード
エッガ・ブランカン	ブレンパワード
伊佐未翠	ブレンパワード
ネリー・キム	ブレンパワード
伊佐未勇	ブレンパワード
宇都宮比瑪	ブレンパワード
レイト	ブレンパワード
コモド・マハマ	ブレンパワード
ジョナサン・グレーン	ブレンパワード
源野三尾	ブレンパワード
カント・ケストナー	ブレンパワード
ゴライアス	ブロッカー軍団IVマシーンブラスター
飛鳥天平	ブロッカー軍団IVマシーンブラスター
海松エル	プラスティック・メモリーズ
桑乃実カヅキ	プラスティック・メモリーズ
絹島ミチル	プラスティック・メモリーズ
素形3四郎	プラレス3四郎
長谷川哲也	プラレス3四郎
真中らぁら	プリティーリズム・オールスターセレクション
春音あいら	プリティーリズム・オールスターセレクション
彩瀬なる	プリティーリズム・オールスターセレクション
上葉みあ	プリティーリズム・オールスターセレクション
ガァルル	プリパラ
レオナ	プリパラ
ぴのん	プリパラ
じゅのん	プリパラ
かのん	プリパラ
大鴉	プリンセスチュチュ
みゅうと	プリンセスチュチュ
エデル	プリンセスチュチュ
江川逞	ベイビーステップ
宮川卓也	ベイビーステップ
マーシャ・オブライアン	ベイビーステップ
アレックス・オブライアン	ベイビーステップ
鷹崎奈津	ベイビーステップ
深沢諭吉	ベイビーステップ
井出義明	ベイビーステップ
清水亜希	ベイビーステップ
岩佐博水	ベイビーステップ
影山小次郎	ベイビーステップ
難波江優	ベイビーステップ
岡田隆行	ベイビーステップ
宮本	ベイビーステップ
池爽児	ベイビーステップ
高木朔夜	ベイビーステップ
大林良	ベイビーステップ
荒谷寛	ベイビーステップ
丸尾栄一郎	ベイビーステップ
よしこ	ベイベーばあちゃん
梅崎	ベターマン
セーメ	ベターマン
彩火乃紀	ベターマン
沢桔梗	ベン・トー
著莪あやめ	ベン・トー
井ノ上あせび	ベン・トー
槍水茉莉花	ベン・トー
金城優	ベン・トー
二階堂連	ベン・トー
沢桔鏡	ベン・トー
佐藤洋	ベン・トー
白梅梅	ベン・トー
槍水仙	ベン・トー
ガストン	ペリーヌ物語
テオドール	ペリーヌ物語
カロリーヌ	ペリーヌ物語
フランソワーズ	ペリーヌ物語
レオーネ	ペリーヌ物語
ヴィットリオ	ペリーヌ物語
ヴァルド	ペリーヌ物語
神郷諒	ペルソナ_〜トリニティ・ソウル〜
橘花沙季	ペルソナ_〜トリニティ・ソウル〜
二階堂映子	ペルソナ_〜トリニティ・ソウル〜
山咲まゆり	ペルソナ_〜トリニティ・ソウル〜
紫倉統馬	ペルソナ_〜トリニティ・ソウル〜
茅野めぐみ	ペルソナ_〜トリニティ・ソウル〜
瀬能壮太郎	ペルソナ_〜トリニティ・ソウル〜
榊葉拓朗	ペルソナ_〜トリニティ・ソウル〜
紀本祐史	ペルソナ_〜トリニティ・ソウル〜
楢崎智弘	ペルソナ_〜トリニティ・ソウル〜
守本叶鳴	ペルソナ_〜トリニティ・ソウル〜
神郷結祈	ペルソナ_〜トリニティ・ソウル〜
伊藤久仁雄	ペルソナ_〜トリニティ・ソウル〜
神郷洵	ペルソナ_〜トリニティ・ソウル〜
戌井暢	ペルソナ_〜トリニティ・ソウル〜
小松原啓祐	ペルソナ_〜トリニティ・ソウル〜
南絵里	ペルソナ4
小西早紀	ペルソナ4
黒田ひさ乃	ペルソナ4
諸岡金四郎	ペルソナ4
久保美津雄	ペルソナ4
生田目太郎	ペルソナ4
上原小夜子	ペルソナ4
鳴上悠	ペルソナ4
足立透	ペルソナ4
柏木典子	ペルソナ4
イザナミ	ペルソナ4
山野真由美	ペルソナ4
小林ジョニー	ペンギンの問題
木下ベッカム	ペンギンの問題
松浦	ペンギンの問題
高橋シャルロット	ペンギンの問題
松井ゆみ	ペンギンの問題
若菜結人	ホイッスル!
佐藤成樹	ホイッスル!
桜庭雄一郎	ホイッスル!
三上亮	ホイッスル!
藤代誠二	ホイッスル!
小岩鉄平	ホイッスル!
杉原多紀	ホイッスル!
笠井竹巳	ホイッスル!
真田一馬	ホイッスル!
椎名翼	ホイッスル!
鳴海貴志	ホイッスル!
畑六助	ホイッスル!
不破大地	ホイッスル!
水野竜也	ホイッスル!
オッター	ボスコアドベンチャー
アプリコット姫	ボスコアドベンチャー
エンダー	ボスコアドベンチャー
ダミア	ボスコアドベンチャー
ハレクラニ	ボボボーボ・ボーボボ
田楽マン	ボボボーボ・ボーボボ
ヘッポコ丸	ボボボーボ・ボーボボ
しじみ	ボボボーボ・ボーボボ
絶望君	ボボボーボ・ボーボボ
パナ	ボボボーボ・ボーボボ
OVER	ボボボーボ・ボーボボ
ソフトン	ボボボーボ・ボーボボ
押田	ボボボーボ・ボーボボ
プルプー	ボボボーボ・ボーボボ
武藤遊戯	ボボボーボ・ボーボボ
サービスマン	ボボボーボ・ボーボボ
やす子	ボボボーボ・ボーボボ
後藤	ボボボーボ・ボーボボ
ツル・ツルリーナ3世	ボボボーボ・ボーボボ
魚雷ガール	ボボボーボ・ボーボボ
ミスティ	ボンバーマンジェッターズ
ムジョー	ボンバーマンジェッターズ
マイティ	ボンバーマンジェッターズ
シロボン	ボンバーマンジェッターズ
戦闘員	ボンバーマンジェッターズ
バーディ	ボンバーマンジェッターズ
ガング	ボンバーマンジェッターズ
ワタル	ポケットモンスター_THE_ORIGIN
オーキド博士	ポケットモンスター_THE_ORIGIN
木の葉ミキ	ポコニャン!
ジャンボ	ポポロクロイス物語
山下マキ	ポヨポヨ観察日記
佐藤茂	ポヨポヨ観察日記
佐藤萌	ポヨポヨ観察日記
パスカル	ポルフィの長い旅
イルマ	ポルフィの長い旅
ロマーヌ	ポルフィの長い旅
トム・スミス	ポルフィの長い旅
バーンズ	ポルフィの長い旅
チッチ	ポルフィの長い旅
マリッサ	ポルフィの長い旅
ハインツ	ポルフィの長い旅
グレタ	ポルフィの長い旅
マンシーニ	ポルフィの長い旅
ブルーノ	ポルフィの長い旅
エヴァ	ポルフィの長い旅
ポルフィ	ポルフィの長い旅
クラウドチェイサー	マイリトルポニー〜トモダチは魔法〜
トーヤ	マギ
ドラコーン	マギ
ドゥニヤ・ムスタシム	マギ
スパルトス	マギ
ハッサン	マギ
オルバ	マギ
リンリー	マギ
練白雄	マギ
ヤムライハ	マギ
ヒナホホ	マギ
イサアク	マギ
練紅炎	マギ
練白龍	マギ
ミラ・ディアノス・アルテミーナ	マギ
夏黄文	マギ
ユナン	マギ
ジャーファル	マギ
ジュダル	マギ
練紅玉	マギ
ゴルタス	マギ
シンドバッド	マギ
ガルダ	マギ
シェヘラザード	マギ
ダリオス・レオクセス	マギ
マイヤーズ	マギ
オットー	マギ
ティトス・アレキウス	マギ
マルガ	マギ
ヒューイ	マギ
ウーゴくん	マギ
練紅明	マギ
練紅覇	マギ
李青秀	マギ
マスルール	マギ
ビョルン	マギ
ラゾル	マギ
練玉艶	マギ
ピスティ	マギ
ファーラン	マギ
イスナーン	マギ
李青舜	マギ
ナージャ	マギ
練白瑛	マギ
ミュロン・アレキウス	マギ
仁々	マギ
ムー・アレキウス	マギ
ピピリカ	マギ
レジーナ	マギ
バルバロッサ	マギ
アリババ・サルージャ	マギ
ザイナブ	マギ
呂斎	マギ
ヤコフ	マギ
マタル・モガメット	マギ
ズルムッド	マギ
北条猛	マグネロボ_ガ・キーン
花月舞	マグネロボ_ガ・キーン
藜チャチャ	マケン姫っ!
六条実	マケン姫っ!
シリア大塚	マケン姫っ!
志那都アズキ	マケン姫っ!
櫛八イナホ	マケン姫っ!
姫神コダマ	マケン姫っ!
クラウド	マシュマロ通信
ゴッドマシュラ	マシュランボー
デスクロウ	マシュランボー
ビンカ	マシュランボー
サーゴ	マシュランボー
ブルージェット	マシンロボ_ぶっちぎりバトルハッカーズ
トリプル・ジム	マシンロボ_クロノスの大逆襲
ナスカ	マシンロボ_クロノスの大逆襲
ギルマン	マシンロボ_クロノスの大逆襲
ガデス	マシンロボ_クロノスの大逆襲
アシュラ	マシンロボ_クロノスの大逆襲
パイロン	マシンロボ_クロノスの大逆襲
レイナ・ストール	マシンロボ_クロノスの大逆襲
ブルー・ジェット	マシンロボ_クロノスの大逆襲
吉川春生	マジカノ
鮎子	マジンガーZ
鬼頭	マジンガーZ
弓弦之助	マジンガーZ
ジェロニモ	マジンガーZ
光雄	マジンガーZ
ダークスパイダー	マジンボーン
竜神智恵	マジンボーン
竜神健悟	マジンボーン
島谷早穂	マジンボーン
竜神智子	マジンボーン
レナード	マジンボーン
アンナ・クリスティン	マジンボーン
ダークスコーピオン	マジンボーン
島谷喜代子	マジンボーン
麻美	マスターモスキートン'99
恵理	マスターモスキートン'99
アイちゃん	マスターモスキートン'99
サンジェルマン伯爵	マスターモスキートン'99
ジュリエッタ・ヴィットーリ	ママは小学4年生
深沢龍一	ママは小学4年生
山口大平	ママは小学4年生
ドリス	ママレード・ボーイ
小石川光希	ママレード・ボーイ
鈴木亜梨実	ママレード・ボーイ
ジニー	ママレード・ボーイ
山口真美	マリア様がみてる
蟹名静	マリア様がみてる
久保栞	マリア様がみてる
英恵	マリア様がみてる
細川可南子	マリア様がみてる
小笠原祥子	マリア様がみてる
島津由乃	マリア様がみてる
有馬菜々	マリア様がみてる
築山三奈子	マリア様がみてる
細川	マリア様がみてる
松平瞳子	マリア様がみてる
鳥居江利子	マリア様がみてる
鵜沢美冬	マリア様がみてる
藤堂志摩子	マリア様がみてる
佐藤聖	マリア様がみてる
水野蓉子	マリア様がみてる
美幸	マリア様がみてる
柏木優	マリア様がみてる
内藤笙子	マリア様がみてる
藤堂	マリア様がみてる
支倉令	マリア様がみてる
敦子	マリア様がみてる
二条乃梨子	マリア様がみてる
音砂みはり	マンガ家さんとアシスタントさんと
足須沙穂都	マンガ家さんとアシスタントさんと
愛徒勇気	マンガ家さんとアシスタントさんと
足須沙穂乃	マンガ家さんとアシスタントさんと
黒井せな	マンガ家さんとアシスタントさんと
皆野まとめ	マンガ家さんとアシスタントさんと
風羽りんな	マンガ家さんとアシスタントさんと
遠石遥架	ミカグラ学園組曲
藤白おとね	ミカグラ学園組曲
蓮見真琴	ミカグラ学園組曲
あきこ	ミス・モノクローム_-The_Animation-
Juno	ミッドナイトホラースクール
Rosso	ミッドナイトホラースクール
麻生敬太郎	ミラクル☆ガールズ
大和田	ミラクル☆ガールズ
水野	ミラクル☆ガールズ
レイコ	ミラクル☆ガールズ
坂倉	ミラクル☆ガールズ
ツカサ	ミラクル☆ガールズ
裕平	ミラクル☆ガールズ
春香	ミラクル☆ガールズ
フレッド	ミラクル☆ガールズ
ライル	ミラクル☆ガールズ
リョウコ	ミラクル☆ガールズ
あかり	ミラクル☆トレイン
有田修三	ミラクルジャイアンツ童夢くん
中畑清	ミラクルジャイアンツ童夢くん
新城まゆみ	ミラクルジャイアンツ童夢くん
原辰徳	ミラクルジャイアンツ童夢くん
山本浩二	ミラクルジャイアンツ童夢くん
落合博満	ミラクルジャイアンツ童夢くん
達川光男	ミラクルジャイアンツ童夢くん
麻生かおり	ミラクルジャイアンツ童夢くん
江川卓	ミラクルジャイアンツ童夢くん
藤田元司	ミラクルジャイアンツ童夢くん
与三郎	ミラクル少女リミットちゃん
浅見信子	ミラクル少女リミットちゃん
りな	ミリオンドール
マリ子	ミリオンドール
オム	ミームいろいろ夢の旅
ミーム	ミームいろいろ夢の旅
秋子	ミームいろいろ夢の旅
アンドレ	ムカムカパラダイス
新子	ムカムカパラダイス
土師圭吾	ムシウタ
鉄丸	ムシブギョー
大岡忠相	ムシブギョー
叶	ムシブギョー
徳川家重	ムシブギョー
徳川吉宗	ムシブギョー
徳川宗直	ムシブギョー
恋川春菊	ムシブギョー
寅吉	ムシブギョー
一乃谷天間	ムシブギョー
弥助	ムシブギョー
蟲奉行	ムシブギョー
ラ・ムー	ムーの白鯨
マドーラ	ムーの白鯨
ポポロ	ムーの白鯨
ミュー	ムーの白鯨
コルド	ムーの白鯨
ハイド	ムーの白鯨
Stinky	ムーミン
ニンニ	ムーミン
キド	メカクシティアクターズ
ケンジロウ	メカクシティアクターズ
アヤノ	メカクシティアクターズ
コノハ	メカクシティアクターズ
田中アントニオ	メガネブ!
高橋マクシミリアン	メガネブ!
三鍋友紀也	メガネブ!
針生恭介	メガネブ!
鉢嶺信司	メガネブ!
鎌谷光希	メガネブ!
佐藤ウィリアム	メガネブ!
白銀穂貴	メガネブ!
相馬輝	メガネブ!
鉢嶺智	メガネブ!
朝比奈鉄	メガネブ!
鈴木徹	メガネブ!
渡辺ロレンツォ	メガネブ!
鉢嶺拓磨	メガネブ!
木全隼人	メガネブ!
湯宮ケンタ	メタルファイト_ベイブレード
越前	メタルファイト_ベイブレード
ソフィ	メタルファイト_ベイブレード
盾神キョウヤ	メタルファイト_ベイブレード
チャウシン	メタルファイト_ベイブレード
天童遊	メタルファイト_ベイブレード
プルート	メタルファイト_ベイブレード
李赤雲	メタルファイト_ベイブレード
毒島	メタルファイト_ベイブレード
ヨハネス	メタルファイト_ベイブレード
ヴァン	メタルファイト_ベイブレード
竜斗	メタルファイト_ベイブレード
角谷正宗	メタルファイト_ベイブレード
ブレーダーDJ	メタルファイト_ベイブレード
水沢ユウキ	メタルファイト_ベイブレード
ウェルズ	メタルファイト_ベイブレード
波佐間ヒカル	メタルファイト_ベイブレード
獅々谷鷹ノ助	メタルファイト_ベイブレード_ZEROG
メルシー	メタルファイト_ベイブレード_ZEROG
破山キラ	メタルファイト_ベイブレード_ZEROG
鋼銀河	メタルファイト_ベイブレード_ZEROG
アルゴ・グレイシー	メタルファイト_ベイブレード_ZEROG
竜牙	メタルファイト_ベイブレード_ZEROG
火竜院忍	メタルファイト_ベイブレード_ZEROG
天野まどか	メタルファイト_ベイブレード_ZEROG
海原カイト	メタルファイト_ベイブレード_ZEROG
暗闇左京	メタルファイト_ベイブレード_ZEROG
セレン・グレイシー	メタルファイト_ベイブレード_ZEROG
海原エイト	メタルファイト_ベイブレード_ZEROG
亀垣玄十郎	メタルファイト_ベイブレード_ZEROG
大鳥翼	メタルファイト_ベイブレード_ZEROG
仮面の男	モノノ怪
徳次	モノノ怪
加世	モノノ怪
瑠璃姫	モノノ怪
佐々木兵衛	モノノ怪
お蝶	モノノ怪
薬売り	モノノ怪
ナーガ	モンスターファーム〜円盤石の秘密〜
モスト	モンスターファーム〜円盤石の秘密〜
エディ	モンスターファーム〜円盤石の秘密〜
ショーグン	モンスターファーム〜円盤石の秘密〜
ポワゾン	モンスターファーム〜円盤石の秘密〜
ナンシー	モンスター娘のいる日常
ティト	モンスター娘のいる日常
喬	モンスター娘のいる日常
サキ	モンスター娘のいる日常
来留主公人	モンスター娘のいる日常
ビスク	モンスター娘のいる日常
ネメス	モンスター娘のいる日常
妖子	モンスター娘のいる日常
ティオニシア	モンスター娘のいる日常
ルディ	モンスター娘のいる日常
ティエラ	モンスター娘のいる日常
エム	モンスター娘のいる日常
ドラコ	モンスター娘のいる日常
アイ	モンスター娘のいる日常
パピ	モンスター娘のいる日常
ゾンビーナ	モンスター娘のいる日常
ルーイ	モンスター娘のいる日常
ルース	モンスター娘のいる日常
リュカ	モンスター娘のいる日常
エナ	モンスター娘のいる日常
メメコ	モンスター娘のいる日常
クーネ	モンスター娘のいる日常
シャロン	モンスター娘のいる日常
デス	モンスター娘のいる日常
レア	モンスター娘のいる日常
フィー	モンスター娘のいる日常
原田真希	モーレツ宇宙海賊
エイプリル・ランバート	モーレツ宇宙海賊
グリュンヒルデ・セレニティ	モーレツ宇宙海賊
イズミ・ユノモト	モーレツ宇宙海賊
アイ・ホシミヤ	モーレツ宇宙海賊
チアキ・クリハラ	モーレツ宇宙海賊
無限彼方	モーレツ宇宙海賊
ミーサ・グランドウッド	モーレツ宇宙海賊
ミレーネ・セルトン	モーレツ宇宙海賊
小林丸翔子	モーレツ宇宙海賊
ヤヨイ・ヨシトミ	モーレツ宇宙海賊
ジェニー・ドリトル	モーレツ宇宙海賊
ベリンダ・パーシー	モーレツ宇宙海賊
シェイン・マクドゥガル	モーレツ宇宙海賊
ケイン・マクドゥガル	モーレツ宇宙海賊
リン・ランブレッタ	モーレツ宇宙海賊
加藤梨理香	モーレツ宇宙海賊
アスタ・アルハンコ	モーレツ宇宙海賊
グリューエル・セレニティ	モーレツ宇宙海賊
遠藤マミ	モーレツ宇宙海賊
クーリエ	モーレツ宇宙海賊
ストーン	モーレツ宇宙海賊
シュニッツァー	モーレツ宇宙海賊
ウルスラ・アブラモフ	モーレツ宇宙海賊
鉄の髭	モーレツ宇宙海賊
タルヴィッキ・ラウノ	モーレツ宇宙海賊
フローラ・チャピー	モーレツ宇宙海賊
リリィ・ベル	モーレツ宇宙海賊
サーシャ・ステイプル	モーレツ宇宙海賊
ブッチ	ヤダモン
リック	ヤダモン
エドワード・ルブラン	ヤダモン
ピート	ヤダモン
タイモン	ヤダモン
小野塚ひかり	ヤマノススメ
笹原ゆうか	ヤマノススメ
倉上健一	ヤマノススメ
青羽ここな	ヤマノススメ
黒崎ほのか	ヤマノススメ
斉藤楓	ヤマノススメ
雪村恵	ヤマノススメ
リツコ	ヤミと帽子と本の旅人
セイレン	ヤミと帽子と本の旅人
初美	ヤミと帽子と本の旅人
アーヤ	ヤミと帽子と本の旅人
クイル	ヤミと帽子と本の旅人
メイリン	ヤミと帽子と本の旅人
百合ヶ咲るる	ユリ熊嵐
百合川このみ	ユリ熊嵐
百合園蜜子	ユリ熊嵐
椿輝紅羽	ユリ熊嵐
みるん	ユリ熊嵐
針島薫	ユリ熊嵐
大木蝶子	ユリ熊嵐
泉乃純花	ユリ熊嵐
華れい子	ライブオン_CARDLIVER_翔
天尾ミル	ライブオン_CARDLIVER_翔
水妖王子ゼニス	ライブオン_CARDLIVER_翔
アリスティア・アグリュー	ラストエグザイル-銀翼のファム-
ルスキニア・ハーフェズ	ラストエグザイル-銀翼のファム-
リリアーナ・イル・グラツィオーソ・メルロー・トゥラン	ラストエグザイル-銀翼のファム-
ウィオラ	ラストエグザイル-銀翼のファム-
クラウス・ヴァルカ	ラストエグザイル-銀翼のファム-
ルネ	ラストエグザイル-銀翼のファム-
ソルーシュ	ラストエグザイル-銀翼のファム-
ミリア・イル・ヴェルク・クトレットラ・トゥラン	ラストエグザイル-銀翼のファム-
ヴァサント	ラストエグザイル-銀翼のファム-
ラヴィ・ヘッド	ラストエグザイル-銀翼のファム-
アデル	ラストエグザイル-銀翼のファム-
ディーオ・エラクレア	ラストエグザイル-銀翼のファム-
タチアナ・ヴィスラ	ラストエグザイル-銀翼のファム-
ヨハン	ラストエグザイル-銀翼のファム-
サーラ	ラストエグザイル-銀翼のファム-
カイザー	ラストエグザイル-銀翼のファム-
真枝絵馬	ラブひな
青山鶴子	ラブひな
乙姫むつみ	ラブひな
前原しのぶ	ラブひな
成瀬川メイ	ラブひな
浦島可奈子	ラブひな
紺野みつね	ラブひな
浦島はるか	ラブひな
佐々木祐理花	ラブゲッCHU_〜ミラクル声優白書〜
綺羅ツバサ	ラブライブ!
西木野真姫	ラブライブ!
星空凛	ラブライブ!
矢澤にこ	ラブライブ!
優木あんじゅ	ラブライブ!
女性シンガー	ラブライブ!
国木田花丸	ラブライブ!
統堂英玲奈	ラブライブ!
絢瀬亜里沙	ラブライブ!
南ことり	ラブライブ!
渡辺曜	ラブライブ!
小泉花陽	ラブライブ!
東條希	ラブライブ!
黒澤ルビィ	ラブライブ!
園田海未	ラブライブ!
高坂雪穂	ラブライブ!
en	ラ・セーヌの星
マリー・アントワネット	ラ・セーヌの星
美嶋玲香	ラーゼフォン
紫東恵	ラーゼフォン
朝比奈浩子	ラーゼフォン
紫東遙	ラーゼフォン
神名綾人	ラーゼフォン
タクミ	リコーダーとランドセル
宮川あつみ	リコーダーとランドセル
松坂花	リコーダーとランドセル
テツヤ	リコーダーとランドセル
盛山ふたみ	リコーダーとランドセル
マルゲリータ	リストランテ・パラディーゾ
ヴィート	リストランテ・パラディーゾ
フリオ	リストランテ・パラディーゾ
ヴァンナ	リストランテ・パラディーゾ
杉並睦実	リトルバスターズ!
ドルジ	リトルバスターズ!
神北小毬	リトルバスターズ!
棗恭介	リトルバスターズ!
朱鷺戸沙耶	リトルバスターズ!
相川	リトルバスターズ!
西園美鳥	リトルバスターズ!
古式みゆき	リトルバスターズ!
三枝葉留佳	リトルバスターズ!
直枝理樹	リトルバスターズ!
棗鈴	リトルバスターズ!
伊藤	リトルバスターズ!
ブラッド	リボンの騎士
ルパン二世	ルパン三世_(TV第1シリーズ)
魔毛狂介	ルパン三世_(TV第1シリーズ)
ハインライン	ルパン三世_(TV第1シリーズ)
ハヤテ	ルパン三世_(TV第1シリーズ)
リーサ	ルパン三世_(TV第1シリーズ)
峰不二子	ルパン三世_(TV第1シリーズ)
ビーバー	ルパン三世_(TV第1シリーズ)
ローズ	ルパン三世_(TV第2シリーズ)
フランソワ	ルパン三世_(TV第2シリーズ)
風魔忍	ルパン三世_(TV第2シリーズ)
オスカル	ルパン三世_(TV第2シリーズ)
ルシア	ルパン三世_(TV第2シリーズ)
ギネス	ルパン三世_(TV第2シリーズ)
ヤスミン	ルパン三世_(TV第2シリーズ)
玄白	ルパン三世_(TV第2シリーズ)
吉良上野介	ルパン三世_(TV第2シリーズ)
ジョージ	ルパン三世_(TV第2シリーズ)
カミーラ	ルパン三世_(TV第2シリーズ)
ジョージ・マーシャル	ルパン三世_(TV第2シリーズ)
錠太郎	ルパン三世_(TV第2シリーズ)
洪秀全	ルパン三世_(TV第2シリーズ)
コーネリア	ルパン三世_(TV第2シリーズ)
ビビアン・リー	ルパン三世_(TV第2シリーズ)
ヘス	ルパン三世_(TV第2シリーズ)
アッシー	ルパン三世_(TV第2シリーズ)
アドルフ・ヒトラー	ルパン三世_(TV第2シリーズ)
チコ	ルパン三世_(TV第2シリーズ)
かぐや	ルパン三世_(TV第2シリーズ)
ベイビー	ルパン三世_(TV第2シリーズ)
元麿	ルパン三世_(TV第2シリーズ)
堀部安兵衛	ルパン三世_(TV第2シリーズ)
マダムX	ルパン三世_(TV第2シリーズ)
山本五十六	ルパン三世_(TV第2シリーズ)
小山田真希	ルパン三世_(TV第2シリーズ)
シャーロック	ルパン三世_(TV第2シリーズ)
モーガン	ルパン三世_(TV第2シリーズ)
ジョー	ルパン三世_(TV第2シリーズ)
ナターシャ	ルパン三世_(TV第2シリーズ)
セルジオ	ルパン三世_(TV第2シリーズ)
スミス	ルパン三世_(TV第2シリーズ)
バッキー	ルパン三世_(TV第2シリーズ)
ブラックキャット	ルパン三世_(TV第2シリーズ)
ヘルガー	ルパン三世_(TV第2シリーズ)
ガスパー	ルパン三世_(TV第2シリーズ)
オルテガ	ルパン三世_PartIII
ローリー	ルパン三世_PartIII
ピーター	ルパン三世_PartIII
ジュリア	ルパン三世_PartIII
ジェニー	ルパン三世_PartIII
ケン	ルパン三世_PartIII
ダイアナ	ルパン三世_PartIII
ノーマン	ルパン三世_PartIII
ゴードン	ルパン三世_PartIII
ドミンゴ	ルパン三世_PartIII
バンコ	ルパン三世_PartIII
バラクーダ	ルパン三世_PartIII
シンドバット	ルパン三世_PartIII
ロン	ルパン三世_PartIII
スージー	ルパン三世_PartIII
エド	レジェンズ_甦る竜王伝説
サラマンダー	レジェンズ_甦る竜王伝説
ズオウ	レジェンズ_甦る竜王伝説
シロン	レジェンズ_甦る竜王伝説
ガーゴイル	レジェンズ_甦る竜王伝説
リリアン	レディ_ジュエルペット
タータ	レディ_ジュエルペット
ビースト	レディ_ジュエルペット
レビン	レディ_ジュエルペット
コハク	レディ_ジュエルペット
ももな	レディ_ジュエルペット
イオ	レディ_ジュエルペット
アレン	レディジョージィ
ケニー	レディジョージィ
ジョイ	レディジョージィ
ケビン	レディジョージィ
野崎	レベルE
清水良樹	レベルE
東尾	レベルE
板倉	レベルE
ラファティ	レベルE
倉本	レベルE
金光	レベルE
筒井雪隆	レベルE
岩田	レベルE
ラピス	レンタルマギカ
影崎	レンタルマギカ
猫屋敷蓮	レンタルマギカ
フィン・クルーダ	レンタルマギカ
葛城みかん	レンタルマギカ
アディリシア・レン・メイザース	レンタルマギカ
黒羽まなみ	レンタルマギカ
伊庭いつき	レンタルマギカ
穂波・高瀬・アンブラー	レンタルマギカ
エポニーヌ	レ・ミゼラブル_少女コゼット
ファンティーヌ	レ・ミゼラブル_少女コゼット
メイエ	レ・ミゼラブル_少女コゼット
井上成美	レーカン!
上原佳菜	レーカン!
メリーさん	レーカン!
小川真琴	レーカン!
江角京子	レーカン!
コギャル霊	レーカン!
天海響	レーカン!
代返侍	レーカン!
山田健太	レーカン!
和久井	ロウきゅーぶ!
羽多野冬子	ロウきゅーぶ!
長谷川七夕	ロウきゅーぶ!
香椎愛莉	ロウきゅーぶ!
長谷川銀河	ロウきゅーぶ!
竹中椿	ロウきゅーぶ!
都大路綾	ロウきゅーぶ!
ミミ・バルゲリー	ロウきゅーぶ!
香椎万里	ロウきゅーぶ!
袴田かげつ	ロウきゅーぶ!
戸嶋	ロウきゅーぶ!
袴田ひなた	ロウきゅーぶ!
竹中柊	ロウきゅーぶ!
柿園さつき	ロウきゅーぶ!
御庄寺多恵	ロウきゅーぶ!
三沢真帆	ロウきゅーぶ!
藍田未有	ロウきゅーぶ!
荻山葵	ロウきゅーぶ!
永塚紗季	ロウきゅーぶ!
菊池	ロウきゅーぶ!
長谷川昴	ロウきゅーぶ!
竹中夏陽	ロウきゅーぶ!
藤井雅美	ロウきゅーぶ!
深田	ロウきゅーぶ!
上原一成	ロウきゅーぶ!
小笠原	ロウきゅーぶ!
篁美星	ロウきゅーぶ!
野火止初恵	ロウきゅーぶ!
ドルチェ	ログ・ホライズン
ヘンリエッタ	ログ・ホライズン
櫛八玉	ログ・ホライズン
ロエ2	ログ・ホライズン
キョウコ	ログ・ホライズン
カーユ	ログ・ホライズン
ルンデルハウス=コード	ログ・ホライズン
イサミ	ログ・ホライズン
セララ	ログ・ホライズン
デミクァス	ログ・ホライズン
にゃん太	ログ・ホライズン
コッペリア	ログ・ホライズン
レザリック	ログ・ホライズン
ミカカゲ	ログ・ホライズン
チカ	ログ・ホライズン
多々良	ログ・ホライズン
ミノリ	ログ・ホライズン
アカツキ	ログ・ホライズン
濡羽	ログ・ホライズン
エリッサ	ログ・ホライズン
KR	ログ・ホライズン
ウパシ	ログ・ホライズン
ウルフ	ログ・ホライズン
白虹	ログ・ホライズン
マリエール	ログ・ホライズン
ロデリック	ログ・ホライズン
アインス	ログ・ホライズン
リ=ガン	ログ・ホライズン
ロンダーク	ログ・ホライズン
三浦茜	ロケットガール
タップマン	ロックマンエグゼAXESS
ウインドマン	ロックマンエグゼAXESS
光祐一朗	ロックマンエグゼBEAST
トマホークマン	ロックマンエグゼBEAST
ダストマン	ロックマンエグゼBEAST
ブルース	ロックマンエグゼBEAST
キラーマン	ロックマンエグゼBEAST
ダイブマン	ロックマンエグゼBEAST
伊集院炎山	ロックマンエグゼBEAST
桜井メイル	ロックマンエグゼBEAST
光熱斗	ロックマンエグゼBEAST
グランドマン	ロックマンエグゼBEAST
アン・エレキテル	ロックマンエグゼBEAST
六方悟	ロックマンエグゼBEAST
チャージマン	ロックマンエグゼBEAST
ダーク・キリサキ	ロックマンエグゼBEAST
ロックマン	ロックマンエグゼBEAST
スラッシュマン	ロックマンエグゼBEAST
サーチマン	ロックマンエグゼBEAST
ディンゴ	ロックマンエグゼBEAST
光正	ロックマンエグゼBEAST
ボンバーマン	ロックマンエグゼStream
砂山ノボル	ロックマンエグゼStream
カラードマン	ロックマンエグゼStream
メディ	ロックマンエグゼStream
クラウドマン	ロックマンエグゼStream
コスモマン	ロックマンエグゼStream
ナルシー・ヒデ	ロックマンエグゼStream
ファイアマン	ロックマンエグゼStream
色綾まどい	ロックマンエグゼStream
ソードマン	ロックマンエグゼStream
大園まりこ	ロックマンエグゼStream
緑川ケロ	ロックマンエグゼStream
シェードマン	ロックマンエグゼStream
グライド	ロックマンエグゼStream
ブライトマン	ロックマンエグゼStream
テスラ・マグネッツ	ロックマンエグゼStream
ブリザードマン	ロックマンエグゼStream
城戸舟子	ロックマンエグゼStream
ダーク・ミヤビ	ロックマンエグゼStream
スパークマン	ロックマンエグゼStream
氷川透	ロックマンエグゼStream
犬飼猛雄	ロックマンエグゼStream
西古レイ	ロックマンエグゼStream
六尺玉燃次	ロックマンエグゼStream
アクアマン	ロックマンエグゼStream
ストーンマン	ロックマンエグゼStream
ナイトマン	ロックマンエグゼStream
ガッツマン	ロックマンエグゼStream
ナパームマン	ロックマンエグゼStream
ナンバーマン	ロックマンエグゼStream
プリンセス・プライド	ロックマンエグゼStream
火野ケンイチ	ロックマンエグゼStream
メタルマン	ロックマンエグゼStream
レーザーマン	ロックマンエグゼStream
日暮闇太郎	ロックマンエグゼStream
ビデオマン	ロックマンエグゼStream
白泉たま子	ロックマンエグゼStream
チャーリー・エアスター	ロックマンエグゼStream
ヤマトマン	ロックマンエグゼStream
ジャンクマン	ロックマンエグゼStream
大山デカオ	ロックマンエグゼStream
真辺鈴	ロックマンエグゼStream
プラントマン	ロックマンエグゼStream
コールドマン	ロックマンエグゼStream
ジャイロマン	ロックマンエグゼStream
綾小路やいと	ロックマンエグゼStream
ビーストマン	ロックマンエグゼStream
ドリルマン	ロックマンエグゼStream
バーナーマン	ロックマンエグゼStream
ガウス・マグネッツ	ロックマンエグゼStream
エレキマン	ロックマンエグゼStream
ミッキー	ロボカーポリー
テリー	ロボカーポリー
ロイ	ロボカーポリー
ジン	ロボカーポリー
スプーキー	ロボカーポリー
ロディ	ロボカーポリー
金作	ロボタン
ハナちゃん	ロボタン
校長先生	ロボタン
ボッチ	ロボタン
ライディーン	ロボットガールズZ
ヒドラー元帥	ロボットガールズZ
ブロッケン伯爵	ロボットガールズZ
ゴーゴン大公	ロボットガールズZ
いまいち萌えない娘	ロボットガールズZ
タケル	ロボットガールズZ
あしゅら男爵	ロボットガールズZ
リーガン	ロミオ×ジュリエット
ウィリアム・シェイクスピア	ロミオ×ジュリエット
キュリオ	ロミオ×ジュリエット
フランシスコ	ロミオ×ジュリエット
アウグスト	ロミオの青い空
ランベルト	ロミオの青い空
ダンテ	ロミオの青い空
アントニオ	ロミオの青い空
マルコ	ロミオの青い空
ジーナ	ロミオの青い空
ロベルト	ロミオの青い空
フランコ	ロミオの青い空
レオン	ロミオの青い空
クリスチーナ	ロミオの青い空
カミラ	ロミオの青い空
白崎	ローゼンメイデン
斉藤	ローゼンメイデン
柏葉巴	ローゼンメイデン
梅岡	ローゼンメイデン
桜田のり	ローゼンメイデン
山口	ローゼンメイデン
山本	ローゼンメイデン
くんくん	ローゼンメイデン
豆千代	ローリング☆ガールズ
小坂結季奈	ローリング☆ガールズ
響逢衣	ローリング☆ガールズ
ダンディ	ローリング☆ガールズ
御園千綾	ローリング☆ガールズ
ベルティーユ・アルチュセール	ワルキューレ_ロマンツェ
龍造寺茜	ワルキューレ_ロマンツェ
柊木綾子	ワルキューレ_ロマンツェ
水野貴弘	ワルキューレ_ロマンツェ
ミレイユ・マーレス・アスコット	ワルキューレ_ロマンツェ
翔子	ワンダーベビルくん
美香	ワンワンセレプー_それゆけ!徹之進
トゥエルブ	ワンワンセレプー_それゆけ!徹之進
犬山ルミ	ワンワンセレプー_それゆけ!徹之進
メリッサ	ワンワンセレプー_それゆけ!徹之進
サスケ	ワンワンセレプー_それゆけ!徹之進
進	ワンワンセレプー_それゆけ!徹之進
ブライ	ワンワンセレプー_それゆけ!徹之進
ビクトリア	ワンワンセレプー_それゆけ!徹之進
徹	ワンワンセレプー_それゆけ!徹之進
ハンゾウ	ワンワンセレプー_それゆけ!徹之進
信康	ワンワンセレプー_それゆけ!徹之進
メグ	ワンワンセレプー_それゆけ!徹之進
イリコ	ワンワンセレプー_それゆけ!徹之進
千代	ワンワンセレプー_それゆけ!徹之進
パブロフ	ワンワンセレプー_それゆけ!徹之進
ドッペル	ワンワンセレプー_それゆけ!徹之進
イワン	ワンワンセレプー_それゆけ!徹之進
オードリー	ワンワンセレプー_それゆけ!徹之進
ひろ子	ワンワンセレプー_それゆけ!徹之進
チン	ワンワンセレプー_それゆけ!徹之進
恭子	ワンワンセレプー_それゆけ!徹之進
ハイレイン	ワールドトリガー
冬島慎次	ワールドトリガー
辻新之助	ワールドトリガー
米屋陽介	ワールドトリガー
雨取麟児	ワールドトリガー
三雲修	ワールドトリガー
雨取千佳	ワールドトリガー
小荒井登	ワールドトリガー
根付栄蔵	ワールドトリガー
小佐野瑠衣	ワールドトリガー
半崎義人	ワールドトリガー
宇佐美栞	ワールドトリガー
巴虎太郎	ワールドトリガー
緑川駿	ワールドトリガー
奈良坂透	ワールドトリガー
天羽月彦	ワールドトリガー
寺島雷蔵	ワールドトリガー
国近柚宇	ワールドトリガー
穂刈篤	ワールドトリガー
日浦茜	ワールドトリガー
照屋文香	ワールドトリガー
迅悠一	ワールドトリガー
風間蒼也	ワールドトリガー
影浦雅人	ワールドトリガー
三上歌歩	ワールドトリガー
空閑遊真	ワールドトリガー
堤大地	ワールドトリガー
志岐小夜子	ワールドトリガー
木虎藍	ワールドトリガー
唐沢克己	ワールドトリガー
荒船哲次	ワールドトリガー
エネドラ	ワールドトリガー
綾辻遥	ワールドトリガー
絵馬ユズル	ワールドトリガー
沢村響子	ワールドトリガー
武富桜子	ワールドトリガー
時枝充	ワールドトリガー
烏丸京介	ワールドトリガー
唯我尊	ワールドトリガー
佐鳥賢	ワールドトリガー
今結花	ワールドトリガー
犬飼澄晴	ワールドトリガー
村上鋼	ワールドトリガー
ヒュース	ワールドトリガー
熊谷友子	ワールドトリガー
夏目出穂	ワールドトリガー
黒江双葉	ワールドトリガー
月見蓮	ワールドトリガー
空閑有吾	ワールドトリガー
嵐山准	ワールドトリガー
出水公平	ワールドトリガー
東春秋	ワールドトリガー
レプリカ	ワールドトリガー
那須玲	ワールドトリガー
人見摩子	ワールドトリガー
当真勇	ワールドトリガー
仁礼光	ワールドトリガー
氷見亜季	ワールドトリガー
加賀美倫	ワールドトリガー
諏訪洸太郎	ワールドトリガー
別役太一	ワールドトリガー
来馬辰也	ワールドトリガー
鳩原未来	ワールドトリガー
ギーヴ	ワールドトリガー
水沼	ワールドトリガー
林藤匠	ワールドトリガー
三輪秀次	ワールドトリガー
奥寺常幸	ワールドトリガー
ラミア	ワールドトリガー
城戸正宗	ワールドトリガー
北添尋	ワールドトリガー
太刀川慶	ワールドトリガー
歌川遼	ワールドトリガー
菊地原士郎	ワールドトリガー
ゼノ	ワールドトリガー
木崎レイジ	ワールドトリガー
ランバネイン	ワールドトリガー
笹森日佐人	ワールドトリガー
柿崎国治	ワールドトリガー
加古望	ワールドトリガー
鬼怒田本吉	ワールドトリガー
二宮匡貴	ワールドトリガー
林藤陽太郎	ワールドトリガー
忍田真史	ワールドトリガー
小南桐絵	ワールドトリガー
クリエイター	ワールド・デストラクション_〜世界撲滅の六人〜
リナン	ワールド・デストラクション_〜世界撲滅の六人〜
ナジャ・グレフ	ワールド・デストラクション_〜世界撲滅の六人〜
カルナ	ワールド・デストラクション_〜世界撲滅の六人〜
トート	ヴァイスクロイツ
百恵	ヴァイスクロイツ
辻井	ヴァイスクロイツ
セナ	ヴァイスクロイツ
キョウ	ヴァイスクロイツ
レックス	ヴァイスクロイツ
ヨージ	ヴァイスクロイツ
オミ	ヴァイスクロイツ
ポーン	ヴァイスクロイツ
希美	ヴァイスクロイツ
結城レイナ	ヴァイスクロイツ
ウータン	ヴァンドレッド
グラン・マ	ヴァンドレッド
メイア・ギズボーン	ヴァンドレッド
ジュラ・ベーシル・エルデン	ヴァンドレッド
ディータ・リーベライ	ヴァンドレッド
遠矢莉磨	ヴァンパイア騎士
錐生零	ヴァンパイア騎士
原島	一球さん
文六	一球さん
丑松	一球さん
住吉	一球さん
中沢	一球さん
藤宮香織	一週間フレンズ。
桐生将吾	一週間フレンズ。
藤宮志穂	一週間フレンズ。
山岸沙希	一週間フレンズ。
九条一	一週間フレンズ。
夏侯淵妙才	一騎当千
袁胤	一騎当千
士孫瑞	一騎当千
孟優	一騎当千
楽進文謙	一騎当千
張飛益徳	一騎当千
黄忠漢升	一騎当千
卑弥呼	一騎当千
陸遜伯言	一騎当千
顔良	一騎当千
劉備玄徳	一騎当千
馬謖幼常	一騎当千
孟獲	一騎当千
于吉	一騎当千
徐晃公明	一騎当千
賈詡文和	一騎当千
文醜	一騎当千
馬超孟起	一騎当千
ルイージ	七つの海のティコ
ロザリンド	七つの海のティコ
鈴木五郎	七人のナナ
メロディー・ハニー	七人のナナ
半田実	七人のナナ
右子	万能文化猫娘
夏目温子	万能文化猫娘
マクベス	三つ目がとおる
写楽保介	三つ目がとおる
ポゴ	三つ目がとおる
アンナ・錦ノ宮	下ネタという概念が存在しない退屈な世界
轟力雷樹	下ネタという概念が存在しない退屈な世界
華城綾女	下ネタという概念が存在しない退屈な世界
不破氷菓	下ネタという概念が存在しない退屈な世界
世IV虎	世界でいちばん強くなりたい!
宮澤エレナ	世界でいちばん強くなりたい!
真田朱里	世界でいちばん強くなりたい!
風間璃緒	世界でいちばん強くなりたい!
ジャッカル東条	世界でいちばん強くなりたい!
福岡萌	世界でいちばん強くなりたい!
ホーネット	世界でいちばん強くなりたい!
萩原さくら	世界でいちばん強くなりたい!
ユンボ山本	世界でいちばん強くなりたい!
豊田美咲	世界でいちばん強くなりたい!
小日向杏	世界一初恋
高屋敷玲二	世界一初恋
横澤隆史	世界一初恋
高野政宗	世界一初恋
柳瀬優	世界一初恋
羽鳥芳雪	世界一初恋
小野寺律	世界一初恋
桐嶋日和	世界一初恋
木佐翔太	世界一初恋
桐嶋禅	世界一初恋
一之瀬絵梨佳	世界一初恋
美濃奏	世界一初恋
雪名皇	世界一初恋
隼房香織	世界征服〜謀略のズヴィズダー〜
地紋明日汰	世界征服〜謀略のズヴィズダー〜
地紋京志郎	世界征服〜謀略のズヴィズダー〜
ピエール	世界征服〜謀略のズヴィズダー〜
駒鳥蓮華	世界征服〜謀略のズヴィズダー〜
ウーム教授	世界征服〜謀略のズヴィズダー〜
ロボ子	世界征服〜謀略のズヴィズダー〜
白鷺美酒	世界征服〜謀略のズヴィズダー〜
鹿羽椿	世界征服〜謀略のズヴィズダー〜
ピェーペル将軍	世界征服〜謀略のズヴィズダー〜
JK	世紀末オカルト学院
中川美風	世紀末オカルト学院
黒木亜美	世紀末オカルト学院
川島千尋	世紀末オカルト学院
内田文明	世紀末オカルト学院
成瀬こずえ	世紀末オカルト学院
五月七日くみん	中二病でも恋がしたい!
九十九七瀬	中二病でも恋がしたい!
凸守早苗	中二病でも恋がしたい!
富樫樟葉	中二病でも恋がしたい!
富樫勇太	中二病でも恋がしたい!
丹生谷森夏	中二病でも恋がしたい!
富樫夢葉	中二病でも恋がしたい!
巫部風鈴	中二病でも恋がしたい!
小鳥遊十花	中二病でも恋がしたい!
一色誠	中二病でも恋がしたい!
能登麻美子	乃木坂春香の秘密
七城那波	乃木坂春香の秘密
小笠原孝	乃木坂春香の秘密
佐藤利奈	乃木坂春香の秘密
綾瀬裕人	乃木坂春香の秘密
朝倉信長	乃木坂春香の秘密
植田佳奈	乃木坂春香の秘密
天宮椎菜	乃木坂春香の秘密
乃木坂美夏	乃木坂春香の秘密
天王寺冬華	乃木坂春香の秘密
桜坂葉月	乃木坂春香の秘密
裕樹	乃木坂春香の秘密
アリアス	乃木坂春香の秘密
清水香里	乃木坂春香の秘密
後藤麻衣	乃木坂春香の秘密
シュート・サザーランド	乃木坂春香の秘密
黒蜥蜴	乱歩奇譚_Game_of_Laplace
影男	乱歩奇譚_Game_of_Laplace
小糸春華	二十面相の娘
トメ	二十面相の娘
ユルゲンス	交響詩篇エウレカセブン
ホランド・ノヴァク	交響詩篇エウレカセブン
マシュー	交響詩篇エウレカセブン
ストナー	交響詩篇エウレカセブン
ムーンドギー	交響詩篇エウレカセブン
ウーノ	交響詩篇エウレカセブン
マリア・シュナイダー	交響詩篇エウレカセブン
ギジェット	交響詩篇エウレカセブン
メーテル	交響詩篇エウレカセブン
ウォズ	交響詩篇エウレカセブン
タルホ・ユーキ	交響詩篇エウレカセブン
こずえ	京四郎と永遠の空
ショーコ博士	京騒戯画
明恵	京騒戯画
菊池久志	人形草紙あやつり左近
吉田憲二	人形草紙あやつり左近
秋月三佳	人形草紙あやつり左近
沖克己	人形草紙あやつり左近
斉藤健一	人形草紙あやつり左近
吉田保	人形草紙あやつり左近
鈴木いくみ	人生相談テレビアニメーション「人生」
志乃	人生相談テレビアニメーション「人生」
黒川真理	人生相談テレビアニメーション「人生」
二階堂彩香	人生相談テレビアニメーション「人生」
村上絵美	人生相談テレビアニメーション「人生」
九条ふみ	人生相談テレビアニメーション「人生」
遠藤梨乃	人生相談テレビアニメーション「人生」
藤田	人生相談テレビアニメーション「人生」
天野河リュウセイ	人造昆虫カブトボーグ_V×V
ムスタファ	人造昆虫カブトボーグ_V×V
石田一	人造昆虫カブトボーグ_V×V
ベネチアン	人造昆虫カブトボーグ_V×V
相馬友子	人造昆虫カブトボーグ_V×V
美奈子	人造昆虫カブトボーグ_V×V
松岡勝治	人造昆虫カブトボーグ_V×V
バーバラ	人造昆虫カブトボーグ_V×V
シェリル	人造昆虫カブトボーグ_V×V
アメリア	人造昆虫カブトボーグ_V×V
天野河銀河	人造昆虫カブトボーグ_V×V
龍昇ケン	人造昆虫カブトボーグ_V×V
シドニー・マンソン	人造昆虫カブトボーグ_V×V
児玉	人造昆虫カブトボーグ_V×V
さやか	人造昆虫カブトボーグ_V×V
サンタクロース	人造昆虫カブトボーグ_V×V
ジャイルジーニョ	人造昆虫カブトボーグ_V×V
ゴンザレス	人造昆虫カブトボーグ_V×V
P子	人類は衰退しました
助手さん	人類は衰退しました
平川ナツミ	今日の5の2
河合ツバサ	今日の5の2
田村	今日の5の2
今井コウジ	今日の5の2
小泉チカ	今日の5の2
楊森	仙界伝_封神演義
太乙真人	仙界伝_封神演義
楊戩	仙界伝_封神演義
黄倉	仙界伝_封神演義
白鶴童子	仙界伝_封神演義
普賢真人	仙界伝_封神演義
黄天化	仙界伝_封神演義
妲己	仙界伝_封神演義
崇黒虎	仙界伝_封神演義
紂王	仙界伝_封神演義
王貴人	仙界伝_封神演義
雷震子	仙界伝_封神演義
申公豹	仙界伝_封神演義
胡喜媚	仙界伝_封神演義
李靖	仙界伝_封神演義
雲中子	仙界伝_封神演義
黄飛虎	仙界伝_封神演義
ジャンヌザルク	仰天人間バトシーラー
ゴルコギャル	仰天人間バトシーラー
武沢	会長はメイド様!
五十嵐虎	会長はメイド様!
鮎沢美咲	会長はメイド様!
さつき	会長はメイド様!
ミラン・フロワード	伝説の勇者の伝説
ルシル・エリス	伝説の勇者の伝説
ノア・エン	伝説の勇者の伝説
クゥ・オルラ	伝説の勇者の伝説
シオン・アスタール	伝説の勇者の伝説
ティーア・ルミブル	伝説の勇者の伝説
イリス・エリス	伝説の勇者の伝説
キファ・ノールズ	伝説の勇者の伝説
斉藤渚	侵略!イカ娘
田辺梢	侵略!イカ娘
望月知美	侵略!イカ娘
渡辺綾乃	侵略!イカ娘
斉藤愛子	侵略!イカ娘
りさ	侵略!イカ娘
常田鮎美	侵略!イカ娘
クラーク	侵略!イカ娘
古川蛍子	侵略!イカ娘
嵐山悟郎	侵略!イカ娘
磯崎辰雄	侵略!イカ娘
黒ミニイカ娘	侵略!イカ娘
松本ユウタ	侵略!イカ娘
相沢たける	侵略!イカ娘
西村由佳	侵略!イカ娘
アレックス	侵略!イカ娘
相沢栄子	侵略!イカ娘
シンディー・キャンベル	侵略!イカ娘
ハリス	侵略!イカ娘
マーティン	侵略!イカ娘
森力丸	信長協奏曲
織田信行	信長協奏曲
遠藤直経	信長協奏曲
羽柴秀長	信長協奏曲
羽柴秀吉	信長協奏曲
堀秀政	信長協奏曲
竹中重治	信長協奏曲
足利義昭	信長協奏曲
簗田政綱	信長協奏曲
森可成	信長協奏曲
蜂須賀小六	信長協奏曲
平手政秀	信長協奏曲
成田隼人	俺たちに翼はない
羽田小鳩	俺たちに翼はない
渡来明日香	俺たちに翼はない
林田美咲	俺たちに翼はない
日野英里子	俺たちに翼はない
真稔	俺たちに翼はない
針生蔵人	俺たちに翼はない
羽田鷹志	俺たちに翼はない
長井	俺たちに翼はない
森里和馬	俺たちに翼はない
玉泉日和子	俺たちに翼はない
望月紀奈子	俺たちに翼はない
鳳翔	俺たちに翼はない
千歳鷲介	俺たちに翼はない
香田亜衣	俺たちに翼はない
伊丹伽楼羅	俺たちに翼はない
三澤	俺たちに翼はない
冬海愛衣	俺の彼女と幼なじみが修羅場すぎる
安岡	俺の彼女と幼なじみが修羅場すぎる
遊井カオル	俺の彼女と幼なじみが修羅場すぎる
季堂鋭太	俺の彼女と幼なじみが修羅場すぎる
黒白院清羅	俺の脳内選択肢が、学園ラブコメを全力で邪魔している
箱庭ゆらぎ	俺の脳内選択肢が、学園ラブコメを全力で邪魔している
麗華堂絢女	俺の脳内選択肢が、学園ラブコメを全力で邪魔している
道楽宴	俺の脳内選択肢が、学園ラブコメを全力で邪魔している
柔風小凪	俺の脳内選択肢が、学園ラブコメを全力で邪魔している
砂川誠	俺物語!!
友寄もり子	健全ロボ_ダイミダラー
天久将馬	健全ロボ_ダイミダラー
ペンギン帝王	健全ロボ_ダイミダラー
又吉一雄	健全ロボ_ダイミダラー
喜友名霧子	健全ロボ_ダイミダラー
ネルソン	健全ロボ_ダイミダラー
真境名そり子	健全ロボ_ダイミダラー
呉屋せわし子	健全ロボ_ダイミダラー
影縫余弦	偽物語
千石撫子	偽物語
貝木泥舟	偽物語
阿良々木暦	偽物語
阿良々木月火	偽物語
神原駿河	偽物語
斧乃木余接	偽物語
阿良々木火憐	偽物語
忍野忍	偽物語
羽川翼	偽物語
八九寺真宵	偽物語
松方弘子	働きマン
高山ケイト	僕は友達が少ない
三日月夜空	僕は友達が少ない
ステラ・レッドフィールド	僕は友達が少ない
羽瀬川小鷹	僕は友達が少ない
ロイド	僕は友達が少ない
羽瀬川小鳩	僕は友達が少ない
日高日向	僕は友達が少ない
長田有希子	僕は友達が少ない
柏崎天馬	僕は友達が少ない
志熊理科	僕は友達が少ない
麻田	僕は友達が少ない
遊佐葵	僕は友達が少ない
楠幸村	僕は友達が少ない
渡辺彩花	僕らはみんな河合荘
黒川	僕らはみんな河合荘
城崎	僕らはみんな河合荘
錦野麻弓	僕らはみんな河合荘
前村	僕らはみんな河合荘
北条	僕らはみんな河合荘
河合住子	僕らはみんな河合荘
山本奈々	僕等がいた
竹内文香	僕等がいた
高橋七美	僕等がいた
水口	僕等がいた
朴ゆう	光と水のダフネ
リー	光と水のダフネ
高橋健太	光と水のダフネ
神哲也	光速電神アルベガス
水木ほたる	光速電神アルベガス
オジョウ	全力ウサギ
緋ノ塚那智	八犬伝―東方八犬異聞―
里見莉芳	八犬伝―東方八犬異聞―
犬川荘介	八犬伝―東方八犬異聞―
犬塚信乃	八犬伝―東方八犬異聞―
犬阪毛野	八犬伝―東方八犬異聞―
雪姫	八犬伝―東方八犬異聞―
犬村大角	八犬伝―東方八犬異聞―
犬田小文吾	八犬伝―東方八犬異聞―
犬江仁	八犬伝―東方八犬異聞―
犬飼現八	八犬伝―東方八犬異聞―
犬山道節	八犬伝―東方八犬異聞―
観月あやね	八犬伝―東方八犬異聞―
華月	八犬伝―東方八犬異聞―
尾崎要	八犬伝―東方八犬異聞―
蒼	八犬伝―東方八犬異聞―
轟嵐子	六三四の剣
杉子	六三四の剣
キッカ	六神合体ゴッドマーズ
日向ミカ	六神合体ゴッドマーズ
ロゼ	六神合体ゴッドマーズ
マーグ	六神合体ゴッドマーズ
ニード	六神合体ゴッドマーズ
アイーダ	六神合体ゴッドマーズ
大塚	六神合体ゴッドマーズ
フレミー・スピッドロウ	六花の勇者
チャモ・ロッソ	六花の勇者
ナッシェタニア・ルーイ・ピエナ・アウグストラ	六花の勇者
ハンス・ハンプティ	六花の勇者
テグネウ	六花の勇者
ジャーネ	六門天外モンコレナイト
柊六奈	六門天外モンコレナイト
バッチィ	六門天外モンコレナイト
グーコ	六門天外モンコレナイト
レプラコーン	六門天外モンコレナイト
ビギナーちゃん	六門天外モンコレナイト
苑田茎子	円盤皇女ワるきゅーレ
真田さん	円盤皇女ワるきゅーレ
ハイドラ	円盤皇女ワるきゅーレ
メーム	円盤皇女ワるきゅーレ
時野リカ	円盤皇女ワるきゅーレ
ワルキューレ	円盤皇女ワるきゅーレ
ライネ	円盤皇女ワるきゅーレ
ワルキューレ・ゴースト	円盤皇女ワるきゅーレ
ファム	円盤皇女ワるきゅーレ
ワるきゅーレ	円盤皇女ワるきゅーレ
ミルファ	冒険王ビィト
ライオ	冒険王ビィト
マチルダ	冒険王ビィト
イーブル	冒険王ビィト
ポアラ	冒険王ビィト
シャギー	冒険王ビィト
バッドル	冒険遊記プラスターワールド
デリィ	冒険遊記プラスターワールド
ヴァローゼ	冒険遊記プラスターワールド
ザガリアン	冒険遊記プラスターワールド
ガブリオン	冒険遊記プラスターワールド
レジェンド	冒険遊記プラスターワールド
イグニス	冒険遊記プラスターワールド
ワイバースト	冒険遊記プラスターワールド
ハーニア	冒険遊記プラスターワールド
直人	冴えない彼女の育てかた
加藤恵	冴えない彼女の育てかた
安芸倫也	冴えない彼女の育てかた
波島出海	冴えない彼女の育てかた
氷堂美智留	冴えない彼女の育てかた
澤村・スペンサー・英梨々	冴えない彼女の育てかた
霞ヶ丘詩羽	冴えない彼女の育てかた
木原紡	凪のあすから
潮留美海	凪のあすから
久沼さゆ	凪のあすから
潮留晃	凪のあすから
比良平ちさき	凪のあすから
狭山旬	凪のあすから
先島あかり	凪のあすから
うろこ様	凪のあすから
先島灯	凪のあすから
伊佐木要	凪のあすから
桂	出撃!マシンロボレスキュー
リッキー	出撃!マシンロボレスキュー
守山	出撃!マシンロボレスキュー
堀田	出撃!マシンロボレスキュー
谷村	出撃!マシンロボレスキュー
木島	出撃!マシンロボレスキュー
ハザード大佐	出撃!マシンロボレスキュー
梅田	出撃!マシンロボレスキュー
宇練銀閣	刀語
真庭蜜蜂	刀語
皿場工舎	刀語
墨ヶ丘黒母	刀語
真庭海亀	刀語
鑢六枝	刀語
彼我木輪廻	刀語
真庭鴛鴦	刀語
真庭川獺	刀語
伊賀甲斐路	刀語
四季崎記紀	刀語
真庭蝙蝠	刀語
凍空こなゆき	刀語
真庭蟷螂	刀語
校倉必	刀語
真庭白鷺	刀語
真庭孑々	刀語
否定姫	刀語
錆白兵	刀語
敦賀迷彩	刀語
巴暁	刀語
呂桐番外	刀語
鑢七実	刀語
真庭喰鮫	刀語
汽口慚愧	刀語
鑢一根	刀語
浮義待秋	刀語
鬼宿不埒	刀語
飛騨鷹比等	刀語
左右田右衛門左衛門	刀語
灰賀欧	刀語
鑢七花	刀語
般若丸	刀語
真庭鳳凰	刀語
渡瀬めぐる	初恋限定。
山本岬	初恋限定。
安藤そあこ	初恋限定。
千倉名央	初恋限定。
別所小宵	初恋限定。
土橋りか	初恋限定。
不動宮すみれ	初恋限定。
江ノ本夕	初恋限定。
龍神	剣勇伝説YAIBA
ゲロ田ゲロ左衛門	剣勇伝説YAIBA
峰さやか	剣勇伝説YAIBA
庄之助	剣勇伝説YAIBA
石川五右衛門	剣勇伝説YAIBA
ゲッコー	剣勇伝説YAIBA
宮本武蔵	剣勇伝説YAIBA
鬼丸猛	剣勇伝説YAIBA
武蔵坊弁慶	剣勇伝説YAIBA
ロペス	創聖のアクエリオン
リーナ・ルーン	創聖のアクエリオン
エスペランサ	創聖のアクエリオン
ピエール・ヴィエラ	創聖のアクエリオン
明日香麗	勇者ライディーン
桜野マリ	勇者ライディーン
戸部真理亜	勇者指令ダグオン
ライアン	勇者指令ダグオン
戸部学	勇者指令ダグオン
ブレイブ星人	勇者指令ダグオン
広瀬渚	勇者指令ダグオン
刃柴美奈子	勇者指令ダグオン
カトリーヌ・ビトン	勇者特急マイトガイン
雷張ジョー	勇者特急マイトガイン
パープル	勇者特急マイトガイン
エグゼブ	勇者特急マイトガイン
吉永サリー	勇者特急マイトガイン
ユリウス	勇者特急マイトガイン
ホイ・コウ・ロウ	勇者特急マイトガイン
ウォルフガング	勇者特急マイトガイン
浜田満彦	勇者特急マイトガイン
ブラック・ノワール	勇者特急マイトガイン
吉永テツヤ	勇者特急マイトガイン
ブラックマイトガイン	勇者特急マイトガイン
冴島十三	勇者警察ジェイデッカー
友永くるみ	勇者警察ジェイデッカー
尾上せいあ	勇者警察ジェイデッカー
友永あずき	勇者警察ジェイデッカー
東一門	勇者警察ジェイデッカー
久世	勇者警察ジェイデッカー
レジーナ・アルジーン	勇者警察ジェイデッカー
ノイバー・フォルツォイク	勇者警察ジェイデッカー
君塚綾子	勇者警察ジェイデッカー
友永亜真美	勇者警察ジェイデッカー
藤堂俊助	勇者警察ジェイデッカー
友永勇一郎	勇者警察ジェイデッカー
エヴァ・フォルツォイク	勇者警察ジェイデッカー
房州	勝負師伝説_哲也
徳三	勝負師伝説_哲也
ドサ健	勝負師伝説_哲也
磯地	勝負師伝説_哲也
忍野メメ	化物語
白石果鈴	北へ。〜Diamond_Dust_Drops〜
北野スオミ	北へ。〜Diamond_Dust_Drops〜
原田明理	北へ。〜Diamond_Dust_Drops〜
甘粕	北へ。〜Diamond_Dust_Drops〜
リュウガ	北斗の拳_ラオウ外伝_天の覇王
廉麟	十二国記
傲濫	十二国記
遠甫	十二国記
楽俊	十二国記
中嶋陽子	十二国記
斡由	十二国記
大木鈴	十二国記
清秀	十二国記
月渓	十二国記
かぐや姫	十二戦支_爆烈エトレンジャー
ピノキオ	十二戦支_爆烈エトレンジャー
メル	十二戦支_爆烈エトレンジャー
ウリィ	十二戦支_爆烈エトレンジャー
バク丸	十二戦支_爆烈エトレンジャー
ティンカーベル	十二戦支_爆烈エトレンジャー
エイハブ	十二戦支_爆烈エトレンジャー
鉄子	十二戦支_爆烈エトレンジャー
ホルス	十二戦支_爆烈エトレンジャー
ニャンマー	十二戦支_爆烈エトレンジャー
ニョロリ	十二戦支_爆烈エトレンジャー
ポチ郎	十二戦支_爆烈エトレンジャー
白雪姫	十二戦支_爆烈エトレンジャー
シンデレラ	十二戦支_爆烈エトレンジャー
リディア	十二戦支_爆烈エトレンジャー
平三	十二戦支_爆烈エトレンジャー
パカラッチ	十二戦支_爆烈エトレンジャー
キリンダー	十二戦支_爆烈エトレンジャー
オーラ姫	十二戦支_爆烈エトレンジャー
ガオウ	十二戦支_爆烈エトレンジャー
ピーターパン	十二戦支_爆烈エトレンジャー
ケイト・ポップル	南の虹のルーシー
ヘラクレス	南の虹のルーシー
デイトン	南の虹のルーシー
島原夕姫	南海奇皇
剣持	双恋
大坂	双恋
池下	史上最強の弟子ケンイチ
岬越寺秋雨	史上最強の弟子ケンイチ
緒方一神斎	史上最強の弟子ケンイチ
アレクサンドル・ガイダル	史上最強の弟子ケンイチ
馬槍月	史上最強の弟子ケンイチ
風林寺美羽	史上最強の弟子ケンイチ
白浜ほのか	史上最強の弟子ケンイチ
香坂しぐれ	史上最強の弟子ケンイチ
クリストファー・エクレール	史上最強の弟子ケンイチ
風林寺隼人	史上最強の弟子ケンイチ
叶翔	史上最強の弟子ケンイチ
朝宮龍斗	史上最強の弟子ケンイチ
李雷薙	史上最強の弟子ケンイチ
馬良	史上最強の弟子ケンイチ
逆鬼至緒	史上最強の弟子ケンイチ
ラデン・ティダード・ジェイハン	史上最強の弟子ケンイチ
シルクァッド・ジュナザード	史上最強の弟子ケンイチ
谷本夏	史上最強の弟子ケンイチ
武田一基	史上最強の弟子ケンイチ
南條キサラ	史上最強の弟子ケンイチ
本郷晶	史上最強の弟子ケンイチ
高原イヨ	吉永さん家のガーゴイル
ハミルトン	吉永さん家のガーゴイル
吉永双葉	吉永さん家のガーゴイル
吉永和己	吉永さん家のガーゴイル
大滝悟郎	名探偵コナン
山岸	名探偵コナン
円谷光彦	名探偵コナン
鈴木史郎	名探偵コナン
弓長	名探偵コナン
松田陣平	名探偵コナン
植松竜司郎	名探偵コナン
高山みなみ	名探偵コナン
宮本由美	名探偵コナン
栗山緑	名探偵コナン
鈴木次郎吉	名探偵コナン
灰原哀	名探偵コナン
米原桜子	名探偵コナン
三池苗子	名探偵コナン
榎本梓	名探偵コナン
小嶋元太	名探偵コナン
沖矢昴	名探偵コナン
鈴木綾子	名探偵コナン
真田貴大	名探偵コナン
鈴木園子	名探偵コナン
京極真	名探偵コナン
赤井秀一	名探偵コナン
世良真純	名探偵コナン
九条玲子	名探偵コナン
本堂瑛祐	名探偵コナン
円谷朝美	名探偵コナン
イーサン・本堂	名探偵コナン
塚本数美	名探偵コナン
山村ミサオ	名探偵コナン
水無怜奈	名探偵コナン
佐藤美和子	名探偵コナン
宮野明美	名探偵コナン
赤木英雄	名探偵コナン
諸伏高明	名探偵コナン
小林澄子	名探偵コナン
浅井成実	名探偵コナン
大和敢助	名探偵コナン
綾小路文麿	名探偵コナン
上原由衣	名探偵コナン
妃英理	名探偵コナン
萩原研二	名探偵コナン
工藤優作	名探偵コナン
目暮十三	名探偵コナン
新出智明	名探偵コナン
白鳥任三郎	名探偵コナン
比護隆佑	名探偵コナン
鈴木朋子	名探偵コナン
横溝重悟	名探偵コナン
森村	名探偵コナン
松本清長	名探偵コナン
伊達航	名探偵コナン
沖野ヨーコ	名探偵コナン
工藤有希子	名探偵コナン
毛利蘭	名探偵コナン
上村直樹	名探偵コナン
服部平蔵	名探偵コナン
目暮みどり	名探偵コナン
黒田兵衛	名探偵コナン
吉田歩美	名探偵コナン
毛利小五郎	名探偵コナン
小田切敏郎	名探偵コナン
宮野エレーナ	名探偵コナン
服部平次	名探偵コナン
百瀬	名探偵コナン
阿笠博士	名探偵コナン
高木渉	名探偵コナン
ワトソン	名探偵ホームズ
トッド	名探偵ホームズ
モリアーティ教授	名探偵ホームズ
ウイリー	名探偵ホームズ
マーサ	名探偵ホームズ
エレン	名探偵ホームズ
スマイリー	名探偵ホームズ
ハラス	名探偵ホームズ
夏目金之助	名探偵ホームズ
レストレード	名探偵ホームズ
五十嵐幸夫	名門!第三野球部
高橋ひろし	名門!第三野球部
上杉錬	君が主で執事が俺で
久遠寺夢	君が主で執事が俺で
上杉美鳩	君が主で執事が俺で
久遠寺未有	君が主で執事が俺で
デニーロ	君が主で執事が俺で
九鬼揚羽	君が主で執事が俺で
星乃文緒	君が望む永遠
穂村愛美	君が望む永遠
榊千鶴	君が望む永遠
速瀬水月	君が望む永遠
鳴海孝之	君が望む永遠
伊藤善之	君が望む永遠
美紀	君が望む永遠
天川蛍	君が望む永遠
辻村晶代	君が望む永遠
玉野まゆ	君が望む永遠
大空寺あゆ	君が望む永遠
佐倉花代	君と僕。
相田日紗子	君と僕。
間宮杏子	君と僕。
高橋里奈	君と僕。
あきら	君と僕。
神咲七海	君のいる町
桐島葵	君のいる町
御島明日香	君のいる町
枝葉懍	君のいる町
ヴェルナー	吟遊黙示録マイネリーベwieder
ジェラルド	吟遊黙示録マイネリーベwieder
ルードヴィッヒ	吟遊黙示録マイネリーベwieder
カミユ	吟遊黙示録マイネリーベwieder
ラヴァ	吸血姫美夕
トモユキ	咎狗の血
キリヲ	咎狗の血
ケイスケ	咎狗の血
福与恒子	咲-Saki-
岡橋初瀬	咲-Saki-
小走やえ	咲-Saki-
杉乃歩	咲-Saki-
熊倉トシ	咲-Saki-
浅見花子	咲-Saki-
荒川憩	咲-Saki-
愛宕絹恵	咲-Saki-
江口セーラ	咲-Saki-
田中舞	咲-Saki-
内木一太	咲-Saki-
土屋由理	咲-Saki-
山口大介	咲-Saki-
蒲原智美	咲-Saki-
深堀純代	咲-Saki-
赤阪郁乃	咲-Saki-
愛宕雅枝	咲-Saki-
狩宿巴	咲-Saki-
針生えり	咲-Saki-
久保貴子	咲-Saki-
大星淡	咲-Saki-
真瀬由子	咲-Saki-
辻垣内智葉	咲-Saki-
佐藤裕子	咲-Saki-
永森和子	咲-Saki-
上柿恵	咲-Saki-
宮永咲	咲-Saki-
鹿倉胡桃	咲-Saki-
西田順子	咲-Saki-
ギバード桜子	咲-Saki-
池田華菜	咲-Saki-
本内成香	咲-Saki-
滝見春	咲-Saki-
井上純	咲-Saki-
渋谷尭深	咲-Saki-
新子憧	咲-Saki-阿知賀編_episode_of_side-A
須賀京太郎	咲-Saki-阿知賀編_episode_of_side-A
瑞原はやり	咲-Saki-阿知賀編_episode_of_side-A
鷺森灼	咲-Saki-阿知賀編_episode_of_side-A
清水谷竜華	咲-Saki-阿知賀編_episode_of_side-A
ヴェーザー	問題児たちが異世界から来るそうですよ?
久遠飛鳥	問題児たちが異世界から来るそうですよ?
逆廻十六夜	問題児たちが異世界から来るそうですよ?
ディーン	問題児たちが異世界から来るそうですよ?
春日部耀	問題児たちが異世界から来るそうですよ?
和泉マミ	喰霊―零―
弐村剣輔	喰霊―零―
三途河カズヒロ	喰霊―零―
土宮神楽	喰霊―零―
岩端晃司	喰霊―零―
諫山黄泉	喰霊―零―
相座凪	四月は君の嘘
宮園かをり	四月は君の嘘
井川絵見	四月は君の嘘
相座武士	四月は君の嘘
斎藤	四月は君の嘘
相島	四畳半神話大系
木下君子	団地ともお
坂上	団地ともお
岡松	団地ともお
福沢	団地ともお
芹沢	団地ともお
宮川	団地ともお
カトリーヌ	団地ともお
塩原	国松さまのお通りだい
横地	国松さまのお通りだい
鬼塚	国松さまのお通りだい
川地	国松さまのお通りだい
伊野	国松さまのお通りだい
菊池静	地獄先生ぬ〜べ〜
立野広	地獄先生ぬ〜べ〜
白戸秀一	地獄先生ぬ〜べ〜
木村克也	地獄先生ぬ〜べ〜
中島法子	地獄先生ぬ〜べ〜
一つ目小僧	地獄先生ぬ〜べ〜
石川	地獄先生ぬ〜べ〜
山田英司	地獄先生ぬ〜べ〜
金田勝	地獄先生ぬ〜べ〜
篠崎愛	地獄先生ぬ〜べ〜
栗田まこと	地獄先生ぬ〜べ〜
細川美樹	地獄先生ぬ〜べ〜
葉月いずな	地獄先生ぬ〜べ〜
山口晶	地獄先生ぬ〜べ〜
尾藤望	地獄少女
閻魔あい	地獄少女
骨女	地獄少女
柴田一	地獄少女
輪入道	地獄少女
柴田あゆみ	地獄少女
稲垣隆史	地獄少女
きくり	地獄少女
御景ゆずき	地獄少女
時枝	坂道のアポロン
迎律子	坂道のアポロン
川渕千太郎	坂道のアポロン
深堀百合香	坂道のアポロン
迎勉	坂道のアポロン
西見薫	坂道のアポロン
小夜子	坂道のアポロン
室井	坂道のアポロン
桂木淳一	坂道のアポロン
まり子	坂道のアポロン
堀内賢雄	坂道のアポロン
真山亜子	坂道のアポロン
櫻田奏	城下町のダンデライオン
櫻田葵	城下町のダンデライオン
菜々緒	城下町のダンデライオン
東雲葉月	城下町のダンデライオン
来兎	境界のRINNE
六道鯖人	境界のRINNE
六文	境界のRINNE
十文字翼	境界のRINNE
井本	境界のRINNE
鳳	境界のRINNE
六道りんね	境界のRINNE
ヨウコ	境界のRINNE
ヤヨイ	境界のRINNE
名瀬泉	境界の彼方
新堂愛	境界の彼方
伊波唯	境界の彼方
二ノ宮雫	境界の彼方
名瀬博臣	境界の彼方
名瀬美月	境界の彼方
藤真弥勒	境界の彼方
神原秋人	境界の彼方
伊波桜	境界の彼方
新堂彩華	境界の彼方
酒井・忠次	境界線上のホライゾン
弘中・隆包	境界線上のホライゾン
江良・房栄	境界線上のホライゾン
三要・光紀	境界線上のホライゾン
マルガ・ナルゼ	境界線上のホライゾン
ハイディ・オーゲザヴァラー	境界線上のホライゾン
点蔵・クロスユナイト	境界線上のホライゾン
御広敷・銀二	境界線上のホライゾン
クリストファー・ハットン	境界線上のホライゾン
本多・忠勝	境界線上のホライゾン
アデーレ・バルフェット	境界線上のホライゾン
トゥーサン・ネシンバラ	境界線上のホライゾン
ウオルター・ローリー	境界線上のホライゾン
ベン・ジョンソン	境界線上のホライゾン
マルゴット・ナイト	境界線上のホライゾン
ミルトン	境界線上のホライゾン
オリオトライ・真喜子	境界線上のホライゾン
フェリペ・セグンド	境界線上のホライゾン
インノケンティウス	境界線上のホライゾン
ディエゴ・ベラスケス	境界線上のホライゾン
前田・利家	境界線上のホライゾン
ロバート・ダッドリー	境界線上のホライゾン
ハッサン・フルブシ	境界線上のホライゾン
立花・誾	境界線上のホライゾン
三科・大	境界線上のホライゾン
鹿角	境界線上のホライゾン
フランシス・ドレイク	境界線上のホライゾン
ニコラス・ベーコン	境界線上のホライゾン
ジョン・ホーキンス	境界線上のホライゾン
キヨナリ・ウルキアガ	境界線上のホライゾン
フローレス・バルデス	境界線上のホライゾン
ペデロ・バルデス	境界線上のホライゾン
水越美和子	変ゼミ
松隆奈々子	変ゼミ
武蔵小麦	変ゼミ
田口イエスタディ	変ゼミ
市河菱靖	変ゼミ
加藤あんな	変ゼミ
上賀茂潤	夏のあらし!
八坂一	夏のあらし!
塩谷	夏のあらし!
山崎加奈子	夏のあらし!
リオウ	夏目友人帳
多軌透	夏目友人帳
民子	夏目友人帳
村崎	夏目友人帳
田沼要	夏目友人帳
カナワ	夏目友人帳
藤原塔子	夏目友人帳
夏目レイコ	夏目友人帳
藤原滋	夏目友人帳
アサギ	夏目友人帳
ちょび	夏目友人帳
北本篤史	夏目友人帳
夏目貴志	夏目友人帳
七瀬	夏目友人帳
西村悟	夏目友人帳
スミエ	夏目友人帳
石尾カイ	夏目友人帳
辻	夏目友人帳
名取周一	夏目友人帳
的場静司	夏目友人帳
啓太	夏色キセキ
祐介	夏色キセキ
浅野	夏色キセキ
笠井	夏色キセキ
葉月亮介	夏雪ランデブー
アッコ	夏雪ランデブー
島尾篤	夏雪ランデブー
島尾ミホ	夏雪ランデブー
赤城忠治	夕やけ番長
エレパントゥス	夜ノヤッターマン
ヴォルトカッツェ	夜ノヤッターマン
ゴロゾウ	夜ノヤッターマン
オダさま	夜ノヤッターマン
ドクロベエ	夜ノヤッターマン
館林火奈	夜桜四重奏_〜ヨザクラカルテット〜
岸恭助	夜桜四重奏_〜ヨザクラカルテット〜
岸桃華	夜桜四重奏_〜ヨザクラカルテット〜
士夏彦八重	夜桜四重奏_〜ヨザクラカルテット〜
瑞樹	夜桜四重奏_〜ヨザクラカルテット〜
七海ギン	夜桜四重奏_〜ヨザクラカルテット〜
館林水奈	夜桜四重奏_〜ヨザクラカルテット〜
観月獅堂	夜桜四重奏_〜ヨザクラカルテット〜
沢木	夜桜四重奏_〜ヨザクラカルテット〜
マリアベル	夜桜四重奏_〜ヨザクラカルテット〜
V・じゅり・F	夜桜四重奏_〜ヨザクラカルテット〜
東鈴	夜桜四重奏_〜ヨザクラカルテット〜
比泉秋名	夜桜四重奏_〜ヨザクラカルテット〜
五十音ことは	夜桜四重奏_〜ヨザクラカルテット〜
槍桜ヒメ	夜桜四重奏_〜ヨザクラカルテット〜
士夏彦雄飛	夜桜四重奏_〜ヨザクラカルテット〜
狂巻ざくろ	夜桜四重奏_〜ヨザクラカルテット〜
V・りら・F	夜桜四重奏_〜ヨザクラカルテット〜
比泉円神	夜桜四重奏_〜ヨザクラカルテット〜
ユックタック	夢のクレヨン王国
レンコポッチ	夢のクレヨン王国
ホーレソレ	夢のクレヨン王国
シャカチック	夢のクレヨン王国
アリ	夢のクレヨン王国
キャーベッタ	夢のクレヨン王国
ニンジッピ	夢のクレヨン王国
ソソソナス	夢のクレヨン王国
ゴマータ	夢のクレヨン王国
ネギック	夢のクレヨン王国
橘一	夢使い
三島燐子	夢使い
ランズボロー	夢喰いメリー
エンギ・スリーピース	夢喰いメリー
エルクレス	夢喰いメリー
ジョン・ドゥ	夢喰いメリー
メリー・ナイトメア	夢喰いメリー
如月みなと	夢喰いメリー
光凪由衣	夢喰いメリー
大菅	夢喰いメリー
橘勇魚	夢喰いメリー
パティ・スリーピース	夢喰いメリー
星野鳴	夢喰いメリー
イチマ	夢喰いメリー
橘のおやっさん	夢喰いメリー
飯島良太	夢喰いメリー
福本	夢戦士ウイングマン
広野健太	夢戦士ウイングマン
森本桃子	夢戦士ウイングマン
小川美紅	夢戦士ウイングマン
布沢久美子	夢戦士ウイングマン
アメリ	夢色パティシエール
村岡	夢色パティシエール
花房五月	夢色パティシエール
樫野真	夢色パティシエール
エストラゴン	夢色パティシエール
小早川	夢色パティシエール
シュリ	夢色パティシエール
メイズ	夢色パティシエール
加藤ルミ	夢色パティシエール
アヌーク	夢色パティシエール
小泉かなこ	夢色パティシエール
安堂千乃介	夢色パティシエール
天野いちご	夢色パティシエール
牛島	夢色パティシエール
ひろ	夢色パティシエール
芹沢水結	大図書館の羊飼い
望月真帆	大図書館の羊飼い
嬉野紗弓実	大図書館の羊飼い
石垣環	大正野球娘。
鈴川小梅	大正野球娘。
岩崎荘介	大正野球娘。
おりく	大江戸ロケット
遠山金四郎	大江戸ロケット
源蔵	大江戸ロケット
天天	大江戸ロケット
銀次郎	大江戸ロケット
駿平	大江戸ロケット
水野忠邦	大江戸ロケット
玉屋清吉	大江戸ロケット
鳥居耀蔵	大江戸ロケット
水坂柚季	天体のメソッド
椎原こはる	天体のメソッド
古川ゆい	失われた未来を求めて
粕屋	奇鋼仙女ロウラン
セディ	奏光のストレイン
コリン	奏光のストレイン
エミリィ	奏光のストレイン
マリエット	奏光のストレイン
小川育恵	女子高生_GIRL'S-HIGH
佐藤綾乃	女子高生_GIRL'S-HIGH
香田あかり	女子高生_GIRL'S-HIGH
松尾薫	女子高生_GIRL'S-HIGH
江崎	女子高生_GIRL'S-HIGH
高橋大地	女子高生_GIRL'S-HIGH
鈴木由真	女子高生_GIRL'S-HIGH
ジャクソン	女王陛下のプティアンジェ
ポピンズ	女王陛下のプティアンジェ
ベンジャミン	女王陛下のプティアンジェ
ティーラ・ザイン・エルメス	女神候補生
キズナ・トゥリーク	女神候補生
みちる	好きっていいなよ。
北川めぐみ	好きっていいなよ。
拓	好きっていいなよ。
鷺月子	妄想代理人
佐藤道子	妄想代理人
マロミ	妄想代理人
謎の老婆	妄想代理人
馬庭光弘	妄想代理人
ミカギ	妖しのセレス
サヤカ	妖怪人間ベム
ミノタウロス	妖怪人間ベム
ベラ	妖怪人間ベム
ハーピー	妖怪人間ベム
アスラ	妖怪人間ベム
ブラックドッグ	妖怪人間ベム
ゴブリン	妖怪人間ベム
ゴア	妖怪人間ベム
白鬼院凜々蝶	妖狐×僕SS
河住小太郎	妖狐×僕SS
河住丈太郎	妖狐×僕SS
御狐神双熾	妖狐×僕SS
雪小路野ばら	妖狐×僕SS
小人村ちの	妖狐×僕SS
反ノ塚連勝	妖狐×僕SS
渡狸卍里	妖狐×僕SS
童辺あゆむ	妖狐×僕SS
幸蛇優二朗	妖狐×僕SS
青鬼院蜻蛉	妖狐×僕SS
夏目残夏	妖狐×僕SS
髏々宮カルタ	妖狐×僕SS
きみどり	妖逆門
三枝敏雄	妖逆門
隠岐清	妖逆門
ナミ	妖逆門
イズナ	妖逆門
デコ	妖逆門
ギグ	妖逆門
日比野ひかる	姫ちゃんのリボン
大王様	姫ちゃんのリボン
野々原姫子	姫ちゃんのリボン
ロベリア	姫ちゃんのリボン
ポコ太	姫ちゃんのリボン
今井蛍	学園アリス
櫻野秀一	学園アリス
槙原	学園アリス
茨木のばら	学園アリス
久遠寺初等部校長	学園アリス
聖陽一	学園アリス
神野	学園アリス
日向棗	学園アリス
成瀬由紀彦	学園ヘヴン_BOY'S_LOVE_HYPER!
七条臣	学園ヘヴン_BOY'S_LOVE_HYPER!
海野聡	学園ヘヴン_BOY'S_LOVE_HYPER!
篠宮紘司	学園ヘヴン_BOY'S_LOVE_HYPER!
伊藤啓太	学園ヘヴン_BOY'S_LOVE_HYPER!
岩井卓人	学園ヘヴン_BOY'S_LOVE_HYPER!
滝俊介	学園ヘヴン_BOY'S_LOVE_HYPER!
ジルトーシュ	学園戦記ムリョウ
磯崎公美	学園戦記ムリョウ
守山那由多	学園戦記ムリョウ
小室孝	学園黙示録_HIGHSCHOOL_OF_THE_DEAD
平野コータ	学園黙示録_HIGHSCHOOL_OF_THE_DEAD
希里ありす	学園黙示録_HIGHSCHOOL_OF_THE_DEAD
卓造	学園黙示録_HIGHSCHOOL_OF_THE_DEAD
角田	学園黙示録_HIGHSCHOOL_OF_THE_DEAD
高城沙耶	学園黙示録_HIGHSCHOOL_OF_THE_DEAD
鞠川静香	学園黙示録_HIGHSCHOOL_OF_THE_DEAD
宮本麗	学園黙示録_HIGHSCHOOL_OF_THE_DEAD
夕樹美玖	学園黙示録_HIGHSCHOOL_OF_THE_DEAD
紫藤浩一	学園黙示録_HIGHSCHOOL_OF_THE_DEAD
田島	学園黙示録_HIGHSCHOOL_OF_THE_DEAD
金子のおっさん	学級王ヤマザキ
藤沢やよい	宇宙のステルヴィア
町田初佳	宇宙のステルヴィア
アリサ・グレンノース	宇宙のステルヴィア
風祭りんな	宇宙のステルヴィア
ヒロ・ナカムラ	宇宙のステルヴィア
天地ひろみ	宇宙の騎士テッカマン
ムータン	宇宙の騎士テッカマン
ノアル・ベルース	宇宙の騎士テッカマンブレード
マドカ	宇宙をかける少女
ニーナ・ストラトスキー	宇宙をかける少女
エル・スール	宇宙をかける少女
リリー	宇宙をかける少女
レオパルド	宇宙をかける少女
ミンタオ	宇宙をかける少女
獅子堂風音	宇宙をかける少女
獅子堂桜	宇宙をかける少女
河合ほのか	宇宙をかける少女
馬場つつじ	宇宙をかける少女
ネルヴァル	宇宙をかける少女
カレン・ジョーンズ	宇宙兄弟
タリー	宇宙兄弟
オジー・スミス	宇宙兄弟
ローリー・クオモ	宇宙兄弟
ブライアン・ジェイ	宇宙兄弟
南波六太	宇宙兄弟
新田零次	宇宙兄弟
風見博士	宇宙大帝ゴッドシグマ
ローザ・アフロディア	宇宙戦士バルディオス
ラスカ	宇宙戦士バルディオス
南部康雄	宇宙戦艦ヤマト2199
加藤三郎	宇宙戦艦ヤマト2199
西川淳	宇宙戦艦ヤマト2199
カリス・クライツェ	宇宙戦艦ヤマト2199
徳川彦左衛門	宇宙戦艦ヤマト2199
古代進	宇宙戦艦ヤマト2199
山南修	宇宙戦艦ヤマト2199
山本玲	宇宙戦艦ヤマト2199
ライル・ゲットー	宇宙戦艦ヤマト2199
原田真琴	宇宙戦艦ヤマト2199
相原義一	宇宙戦艦ヤマト2199
ヴァルケ・シュルツ	宇宙戦艦ヤマト2199
メルダ・ディッツ	宇宙戦艦ヤマト2199
薮助治	宇宙戦艦ヤマト2199
平田一	宇宙戦艦ヤマト2199
太田健二郎	宇宙戦艦ヤマト2199
斉藤始	宇宙戦艦ヤマト2199
徳川太助	宇宙戦艦ヤマト2199
藤堂平九郎	宇宙戦艦ヤマト2199
榎本勇	宇宙戦艦ヤマト2199
真田志郎	宇宙戦艦ヤマト2199
山崎奨	宇宙戦艦ヤマト2199
島次郎	宇宙戦艦ヤマト2199
島大介	宇宙戦艦ヤマト2199
市川純	宇宙戦艦ヤマト2199
森雪	宇宙戦艦ヤマト2199
古代守	宇宙戦艦ヤマト2199
土方竜	宇宙戦艦ヤマト2199
島沙織	宇宙戦艦ヤマト2199
新見薫	宇宙戦艦ヤマト2199
ヤッタラン	宇宙海賊キャプテンハーロック
アマン	宇宙海賊キャプテンハーロック
アドルフ	宇宙海賊キャプテンハーロック
キリカ	宇宙海賊キャプテンハーロック
有紀螢	宇宙海賊キャプテンハーロック
カサンドラ	宇宙海賊キャプテンハーロック
ラフレシア	宇宙海賊キャプテンハーロック
大久保都	宇宙海賊ミトの大冒険
年賀睦月	宇宙海賊ミトの大冒険
リブ	宇宙船サジタリウス
真由	宙のまにまに
京	宙のまにまに
桜川	宙のまにまに
矢来小夜	宙のまにまに
江戸川正志	宙のまにまに
路万健康	宙のまにまに
蒔田姫	宙のまにまに
明野美星	宙のまにまに
原口	宙のまにまに
宮前	宙のまにまに
琴塚文江	宙のまにまに
木田	宙のまにまに
草間望	宙のまにまに
紅本茜	実は私は
マチア	家なき子レミ
獄寺隼人	家庭教師ヒットマンREBORN!
笹川京子	家庭教師ヒットマンREBORN!
柿本千種	家庭教師ヒットマンREBORN!
鈴木アーデルハイト	家庭教師ヒットマンREBORN!
ブルーベル	家庭教師ヒットマンREBORN!
三浦ハル	家庭教師ヒットマンREBORN!
ソルテ	家庭教師ヒットマンREBORN!
城島犬	家庭教師ヒットマンREBORN!
グロ・キシニア	家庭教師ヒットマンREBORN!
バーズ	家庭教師ヒットマンREBORN!
レンジー	家庭教師ヒットマンREBORN!
入江正一	家庭教師ヒットマンREBORN!
ランボ	家庭教師ヒットマンREBORN!
草壁哲矢	家庭教師ヒットマンREBORN!
笹川了平	家庭教師ヒットマンREBORN!
ロマーリオ	家庭教師ヒットマンREBORN!
山本武	家庭教師ヒットマンREBORN!
古里炎真	家庭教師ヒットマンREBORN!
沢田綱吉	家庭教師ヒットマンREBORN!
六道骸	家庭教師ヒットマンREBORN!
沢田奈々	家庭教師ヒットマンREBORN!
ブリガンテス	家庭教師ヒットマンREBORN!
白蘭	家庭教師ヒットマンREBORN!
ヴェルデ	家庭教師ヒットマンREBORN!
ラル・ミルチ	家庭教師ヒットマンREBORN!
水野薫	家庭教師ヒットマンREBORN!
バイパー	家庭教師ヒットマンREBORN!
青葉紅葉	家庭教師ヒットマンREBORN!
M・M	家庭教師ヒットマンREBORN!
リゾーナ	家庭教師ヒットマンREBORN!
ジェラーロ	家庭教師ヒットマンREBORN!
コロネロ	家庭教師ヒットマンREBORN!
クローム髑髏	家庭教師ヒットマンREBORN!
ジンジャー・ブレッド	家庭教師ヒットマンREBORN!
加藤ジュリー	家庭教師ヒットマンREBORN!
イーピン	家庭教師ヒットマンREBORN!
幻騎士	家庭教師ヒットマンREBORN!
雲雀恭弥	家庭教師ヒットマンREBORN!
アルビート	家庭教師ヒットマンREBORN!
ビアンキ	家庭教師ヒットマンREBORN!
Dr.シャマル	家庭教師ヒットマンREBORN!
山本剛	家庭教師ヒットマンREBORN!
太猿	家庭教師ヒットマンREBORN!
田村玲子	寄生獣_セイの格率
広川剛志	寄生獣_セイの格率
君嶋加奈	寄生獣_セイの格率
浦上	寄生獣_セイの格率
三木	寄生獣_セイの格率
立川裕子	寄生獣_セイの格率
美津代	寄生獣_セイの格率
平間	寄生獣_セイの格率
ミギー	寄生獣_セイの格率
村野里美	寄生獣_セイの格率
クリステル	小公女セーラ
ジェシー	小公女セーラ
ベッキー	小公女セーラ
ラビニア・ハーバート	小公女セーラ
マギー	小公女セーラ
アンヌ	小公女セーラ
ブリジット	小公子セディ
ジェファーソン	小公子セディ
ミンナ	小公子セディ
コッキー	小公子セディ
菊地	少女たちは荒野を目指す
令子	少女たちは荒野を目指す
安西	少年アシベ
秋雄	少年アシベ
味田	少年アシベ
イエティ	少年アシベ
ペッペッペッ・ソーランアレマ	少年アシベ
まゆみ	少年アシベ
王	少年アシベ
エイジ	少年アシベ
阿南スガオ	少年アシベ
ノリコ	少年アシベ
アッキー	少年アシベ
富井大樹	少年ハリウッド_-HOLLY_STAGE_FOR_49-
早水海馬	少年ハリウッド_-HOLLY_STAGE_FOR_49-
佐伯希星	少年ハリウッド_-HOLLY_STAGE_FOR_49-
風見颯	少年ハリウッド_-HOLLY_STAGE_FOR_49-
富井実	少年ハリウッド_-HOLLY_STAGE_FOR_49-
広澤大地	少年ハリウッド_-HOLLY_STAGE_FOR_49-
伊達竜之介	少年ハリウッド_-HOLLY_STAGE_FOR_49-
勅使河原恭一	少年ハリウッド_-HOLLY_STAGE_FOR_49-
大咲香	少年ハリウッド_-HOLLY_STAGE_FOR_49-
甘木生馬	少年ハリウッド_-HOLLY_STAGE_FOR_49-
柊剛人	少年ハリウッド_-HOLLY_STAGE_FOR_49-
風原乱	少年ハリウッド_-HOLLY_STAGE_FOR_49-
舞山春	少年ハリウッド_-HOLLY_STAGE_FOR_49-
安倍晴明	少年陰陽師
脩子内親王	少年陰陽師
もっくん	少年陰陽師
風音	少年陰陽師
一条天皇	少年陰陽師
理子	屍姫_赫
光良	屍姫_赫
御咲君	屍姫_赫
本多	屍姫_赫
黒猫	屍姫_赫
遠岡アキラ	屍姫_赫
星村眞姫那	屍姫_赫
萩野	屍姫_赫
神生真世	屍姫_赫
室井静信	屍鬼
結城	屍鬼
柚木	屍鬼
松尾静	屍鬼
国広律子	屍鬼
田中かおり	屍鬼
武藤徹	屍鬼
田中昭	屍鬼
倉橋佳枝	屍鬼
広沢	屍鬼
村迫正雄	屍鬼
長谷川	屍鬼
前田勇	屍鬼
清水武雄	屍鬼
田茂定文	屍鬼
井崎聡子	屍鬼
尾崎	屍鬼
清水恵	屍鬼
池辺	屍鬼
十和田	屍鬼
尾崎敏夫	屍鬼
田中良和	屍鬼
武藤	屍鬼
前田巌	屍鬼
速見	屍鬼
飛鳥美琴	山田くんと7人の魔女
小田切寧々	山田くんと7人の魔女
伊藤雅	山田くんと7人の魔女
西園寺リカ	山田くんと7人の魔女
玉木真一	山田くんと7人の魔女
大塚芽子	山田くんと7人の魔女
滝川ノア	山田くんと7人の魔女
宮村虎之介	山田くんと7人の魔女
猿島マリア	山田くんと7人の魔女
ジェフ	巨神ゴーグ
ベーム	巨神ゴーグ
九重クレア	帰宅部活動記録
古橋愛	帰宅部活動記録
塔野花梨	帰宅部活動記録
道明寺桜	帰宅部活動記録
金田正男	帰宅部活動記録
大萩牡丹	帰宅部活動記録
ジョン万次郎	幕末Rock
原田左之助	幕末Rock
井伊直弼	幕末Rock
藤堂平助	幕末Rock
高松凌雲	幕末機関説_いろはにほへと
新門辰五郎	幕末機関説_いろはにほへと
益満休之助	幕末機関説_いろはにほへと
榎本武揚	幕末機関説_いろはにほへと
大村益次郎	幕末機関説_いろはにほへと
市村鉄之助	幕末機関説_いろはにほへと
遊山赫乃丈	幕末機関説_いろはにほへと
河井継之助	幕末機関説_いろはにほへと
山岡鉄舟	幕末機関説_いろはにほへと
中居屋重兵衛	幕末機関説_いろはにほへと
ジュール・ブリュネ	幕末機関説_いろはにほへと
柳沢吉保	幕末義人伝_浪漫
阿国	幕末義人伝_浪漫
鈴木孫一	幕末義人伝_浪漫
徳川家定	幕末義人伝_浪漫
玄太	幕末義人伝_浪漫
与平	幕末義人伝_浪漫
次郎吉	幕末義人伝_浪漫
西郷	幕末義人伝_浪漫
コンティ	幕末義人伝_浪漫
海老名菜々	干物妹!うまるちゃん
橘・シルフィンフォード	干物妹!うまるちゃん
本場猛	干物妹!うまるちゃん
本場切絵	干物妹!うまるちゃん
倉元	平成イヌ物語バウ
内木ユキ	幸腹グラフィティ
町子明	幸腹グラフィティ
露子	幸腹グラフィティ
森野きりん	幸腹グラフィティ
白金ぎんか	幻影ヲ駆ケル太陽
太陽ひなた	幻影ヲ駆ケル太陽
心崎冬菜	幻影ヲ駆ケル太陽
アリエル・ヴァルティエル・ウェストコット	幻影ヲ駆ケル太陽
ケルブレム	幻影ヲ駆ケル太陽
プリシラ・トワイライト	幻影ヲ駆ケル太陽
エティア・ヴィスコンティ	幻影ヲ駆ケル太陽
星河せいら	幻影ヲ駆ケル太陽
月詠るな	幻影ヲ駆ケル太陽
ミミー	幻魔大戦_神話前夜の章
橘綾	弱虫ペダル
東堂尽八	弱虫ペダル
手嶋純太	弱虫ペダル
今泉俊輔	弱虫ペダル
山口紀之	弱虫ペダル
金城真護	弱虫ペダル
水田信行	弱虫ペダル
柴田康之	弱虫ペダル
桜井剛	弱虫ペダル
御堂筋翔	弱虫ペダル
鳴子章吉	弱虫ペダル
東村	弱虫ペダル
辻明久	弱虫ペダル
寒咲幹	弱虫ペダル
田所迅	弱虫ペダル
荒北靖友	弱虫ペダル
巻島裕介	弱虫ペダル
杉元照文	弱虫ペダル
田浦良昭	弱虫ペダル
井尾谷諒	弱虫ペダル
真波山岳	弱虫ペダル
新開隼人	弱虫ペダル
黒田雪成	弱虫ペダル
塩野	弱虫ペダル
館林元成	弱虫ペダル
寒咲通司	弱虫ペダル
井原友矢	弱虫ペダル
Mr.ピエール	弱虫ペダル
大粒健士	弱虫ペダル
福富寿一	弱虫ペダル
泉田塔一郎	弱虫ペダル
井瀬	弱虫ペダル
待宮栄吉	弱虫ペダル
青八木一	弱虫ペダル
石垣光太郎	弱虫ペダル
大名侍鳴	彼女がフラグをおられたら
忍者林瑠璃	彼女がフラグをおられたら
英雄崎凜	彼女がフラグをおられたら
魔法ヶ沢茜	彼女がフラグをおられたら
白亜・B・ブレードフィールド	彼女がフラグをおられたら
召喚寺菊乃	彼女がフラグをおられたら
盗賊山恵	彼女がフラグをおられたら
吟遊院芹香	彼女がフラグをおられたら
大司教河くるみ子	彼女がフラグをおられたら
菜波・K・ブレードフィールド	彼女がフラグをおられたら
旗立颯太	彼女がフラグをおられたら
聖帝小路美森	彼女がフラグをおられたら
龍騎士原月麦	彼女がフラグをおられたら
芝姫一馬	彼氏彼女の事情
佐倉椿	彼氏彼女の事情
井沢真秀	彼氏彼女の事情
小橋	彼氏彼女の事情
宮沢雪野	彼氏彼女の事情
有馬総一郎	彼氏彼女の事情
黄昏甚兵衛	忍たま乱太郎
花江	忍たま乱太郎
小松田優作	忍たま乱太郎
網問	忍たま乱太郎
飯加玄南	忍たま乱太郎
加場出居介	忍たま乱太郎
山本陣内	忍たま乱太郎
竜王丸	忍たま乱太郎
田府甲斐幻鬼	忍たま乱太郎
八味地黄丸	忍たま乱太郎
高坂陣内左衛門	忍たま乱太郎
清八	忍たま乱太郎
月乃	忍たま乱太郎
梵天丸	忍たま乱太郎
山田利吉	忍たま乱太郎
由良四郎	忍たま乱太郎
義丸	忍たま乱太郎
諸泉尊奈門	忍たま乱太郎
錫高野与四郎	忍たま乱太郎
野牛金鉄	忍たま乱太郎
おりん	忍たま乱太郎
二平	忍たま乱太郎
福富カメ子	忍たま乱太郎
雑渡昆奈門	忍たま乱太郎
白南風丸	忍たま乱太郎
押都長烈	忍たま乱太郎
土寿烏	忍たま乱太郎
鬼蜘蛛丸	忍たま乱太郎
舳丸	忍たま乱太郎
花房牧之介	忍たま乱太郎
佐茂有南	忍たま乱太郎
灰洲井溝	忍たま乱太郎
真美子	忍ペンまん丸
乱子	忍ペンまん丸
ネンガ様	忍ペンまん丸
亥助	忍ペンまん丸
ギオ	忍ペンまん丸
ハットリカンゾウ	忍者ハットリくん
影千代	忍者ハットリくん
河合夢子	忍者ハットリくん
愛子	忍者ハットリくん
根来	忍者マン一平
伊賀山	忍者マン一平
レニー・アイ	忍者戦士飛影
川久保	快傑蒸気探偵団
源四郎	怪_〜ayakashi〜
小田島	怪_〜ayakashi〜
鶴屋南北	怪_〜ayakashi〜
弥平	怪_〜ayakashi〜
勝山	怪_〜ayakashi〜
直助権兵衛	怪_〜ayakashi〜
笹岡	怪_〜ayakashi〜
富姫	怪_〜ayakashi〜
珠生	怪_〜ayakashi〜
坂井水江	怪_〜ayakashi〜
村山	怪物王女
カネ子	怪盗ジョーカー
黒崎ギンコ	怪盗ジョーカー
白井モモ	怪盗ジョーカー
ダーク・アイ	怪盗ジョーカー
ビリジアン	怪盗ジョーカー
アリババ	怪盗ジョーカー
レディー・ダウト	怪盗ジョーカー
速水京太郎	怪盗ジョーカー
プロフェッサー・C	怪盗ジョーカー
スパイダーA	怪盗ジョーカー
靖広	怪盗セイント・テール
ルビィ	怪盗セイント・テール
婦警のっち	怪盗レーニャ
拝田希実花	恋と選挙とチョコレート
枝川希美	恋と選挙とチョコレート
東雲皐月	恋と選挙とチョコレート
奈々瀬奉莉	恋と選挙とチョコレート
住吉千里	恋と選挙とチョコレート
猿江愛	恋と選挙とチョコレート
木場美冬	恋と選挙とチョコレート
茂森真央	恋と選挙とチョコレート
門前仲綺衣	恋と選挙とチョコレート
青海衣更	恋と選挙とチョコレート
森下未散	恋と選挙とチョコレート
大島裕樹	恋と選挙とチョコレート
夢島朧	恋と選挙とチョコレート
桂木	恋愛ラボ
南桃香	恋愛ラボ
山崎佑	恋愛ラボ
倉橋由美子	恋愛ラボ
市川奈々	恋愛ラボ
立花	恋愛ラボ
テレス	恐竜冒険記ジュラトリッパー
アジャリ	恐竜冒険記ジュラトリッパー
シーザー	恐竜冒険記ジュラトリッパー
カグラ	恐竜冒険記ジュラトリッパー
モジ	恐竜冒険記ジュラトリッパー
犬飼恵介	悪魔のリドル
神長香子	悪魔のリドル
生田目千足	悪魔のリドル
英純恋子	悪魔のリドル
東兎角	悪魔のリドル
武智乙哉	悪魔のリドル
寒河江春紀	悪魔のリドル
走り鳰	悪魔のリドル
剣持しえな	悪魔のリドル
桐ヶ谷柩	悪魔のリドル
犬飼伊介	悪魔のリドル
首藤涼	悪魔のリドル
金谷	惑星ロボ_ダンガードA
エバンス	惑星ロボ_ダンガードA
ジョン・グレイ	惑星ロボ_ダンガードA
久保	惑星ロボ_ダンガードA
フランク	惑星ロボ_ダンガードA
佐渡酒造	惑星ロボ_ダンガードA
仲村佐和	惡の華
佐伯奈々子	惡の華
山田正和	惡の華
まりか	愛してるぜベイベ★★
坂下ゆずゆ	愛してるぜベイベ★★
徳永心	愛してるぜベイベ★★
加藤剛	愛してナイト
藤木	愛してナイト
エイミー・マーチ	愛の若草物語
エスター	愛の若草物語
フレデリック・マーチ	愛の若草物語
れい子	愛天使伝説ウェディングピーチ
木原	愛天使伝説ウェディングピーチ
風摩ようすけ	愛天使伝説ウェディングピーチ
園子	愛天使伝説ウェディングピーチ
プリュイ	愛天使伝説ウェディングピーチ
小悪魔	愛天使伝説ウェディングピーチ
リモーネ	愛天使伝説ウェディングピーチ
じゃ魔ピー	愛天使伝説ウェディングピーチ
ブリッツ	愛天使伝説ウェディングピーチ
玲子	愛天使伝説ウェディングピーチ
スーシー	愛少女ポリアンナ物語
七瀬香奈花	成恵の世界
朝倉鈴	成恵の世界
飯塚和人	成恵の世界
音無麗	成恵の世界
天堂蘭	成恵の世界
高上昇	我が家のお稲荷さま。
佐倉美咲	我が家のお稲荷さま。
拝一刀	我が家のお稲荷さま。
座敷童子	我が家のお稲荷さま。
大五郎	我が家のお稲荷さま。
橋姫	我が家のお稲荷さま。
鮫島	戦勇。
ロス	戦勇。
ニセパンダ	戦勇。
ユーリ	戦勇。
アレス	戦勇。
ヒメちゃん	戦勇。
ルキ	戦勇。
真田昌幸	戦国BASARA
島左近	戦国BASARA
竹中半兵衛	戦国BASARA
天海	戦国BASARA
浅井長政	戦国BASARA
雑賀孫市	戦国BASARA
鶴姫	戦国BASARA
おやっさん	戦国BASARA
安兵衛	戦国BASARA
酒井忠次	戦国BASARA
佐竹義重	戦国BASARA
織田信長	戦国BASARA
最上義光	戦国BASARA
森蘭丸	戦国BASARA
島津義弘	戦国BASARA
後藤又兵衛	戦国BASARA
濃姫	戦国BASARA
今川義元	戦国BASARA
宇都宮広綱	戦国BASARA
京極マリア	戦国BASARA
豊臣秀吉	戦国BASARA
前田利家	戦国BASARA
柴田勝家	戦国BASARA
尼子晴久	戦国BASARA
立花宗茂	戦国BASARA
大谷吉継	戦国BASARA
お市	戦国BASARA
大友宗麟	戦国BASARA
松永久秀	戦国BASARA
上杉謙信	戦国BASARA
真田信之	戦国BASARA
千利休	戦国BASARA
足利義輝	戦国BASARA
北条氏政	戦国BASARA
赤川元保	戦国BASARA
黒田官兵衛	戦国BASARA
毛利元就	戦国BASARA
亜衣	戦国コレクション
松子	戦国コレクション
アゲハ	戦国コレクション
平賀源内	戦国コレクション
ペリー	戦国コレクション
陸遜	戦国コレクション
恭一	戦国コレクション
沖田総司	戦国コレクション
ナポレオン	戦国コレクション
カエサル	戦国コレクション
景子	戦国コレクション
高橋純	戦国コレクション
北条早雲	戦国コレクション
塚原卜伝	戦国コレクション
由美	戦国コレクション
杉谷善住坊	戦国コレクション
村田	戦国コレクション
西郷隆盛	戦国コレクション
土方歳三	戦国コレクション
風魔小太郎	戦国コレクション
劉備	戦国コレクション
真理恵	戦国コレクション
神原	戦国コレクション
二川	戦国コレクション
紀子	戦国コレクション
クレオパトラ	戦国コレクション
尼子経久	戦国コレクション
松尾芭蕉	戦国コレクション
真緒	戦国コレクション
ベートーベン	戦国コレクション
大友ソウリン	戦国乙女〜桃色パラドックス〜
長宗我部モトチカ	戦国乙女〜桃色パラドックス〜
織田ノブナガ	戦国乙女〜桃色パラドックス〜
明智ミツヒデ	戦国乙女〜桃色パラドックス〜
毛利モトナリ	戦国乙女〜桃色パラドックス〜
サントス	戦国魔神ゴーショーグン
ジミー	戦国魔神ゴーショーグン
キリー・ギャグレー	戦国魔神ゴーショーグン
風鳴八紘	戦姫絶唱シンフォギア
ネフィリム	戦姫絶唱シンフォギア
立花洸	戦姫絶唱シンフォギア
エルフナイン	戦姫絶唱シンフォギア
セレナ・カデンツァヴナ・イヴ	戦姫絶唱シンフォギア
友里あおい	戦姫絶唱シンフォギア
緒川慎次	戦姫絶唱シンフォギア
天羽奏	戦姫絶唱シンフォギア
キャロル・マールス・ディーンハイム	戦姫絶唱シンフォギア
小日向未来	戦姫絶唱シンフォギア
ガリィ・トゥーマーン	戦姫絶唱シンフォギア
風鳴翼	戦姫絶唱シンフォギア
月読調	戦姫絶唱シンフォギア
マリア・カデンツァヴナ・イヴ	戦姫絶唱シンフォギア
ミカ・ジャウカーン	戦姫絶唱シンフォギア
藤尭朔也	戦姫絶唱シンフォギア
広木威椎	戦姫絶唱シンフォギア
安藤創世	戦姫絶唱シンフォギア
風鳴弦十郎	戦姫絶唱シンフォギア
暁切歌	戦姫絶唱シンフォギア
雪音クリス	戦姫絶唱シンフォギア
ファラ・スユーフ	戦姫絶唱シンフォギア
レイア・ダラーヒム	戦姫絶唱シンフォギア
トニー・グレイザー	戦姫絶唱シンフォギア
寺島詩織	戦姫絶唱シンフォギア
ラグ・ウラロ	戦闘メカ_ザブングル
ゼム	戦闘メカ_ザブングル
ホッター	戦闘メカ_ザブングル
ヨーゼフ	戦闘メカ_ザブングル
グレタ・カラス	戦闘メカ_ザブングル
ビリン・ナダ	戦闘メカ_ザブングル
ティンプ・シャローン	戦闘メカ_ザブングル
マリア・マリア	戦闘メカ_ザブングル
コリンズ	戦闘メカ_ザブングル
チル	戦闘メカ_ザブングル
ゴッチ	戦闘メカ_ザブングル
キャローン・キャル	戦闘メカ_ザブングル
ブルメ	戦闘メカ_ザブングル
ザイラー	戦闘メカ_ザブングル
アーサー・ランク	戦闘メカ_ザブングル
エルチ・カーゴ	戦闘メカ_ザブングル
トロン・ミラン	戦闘メカ_ザブングル
ケイト	探偵オペラ_ミルキィホームズ
常盤カズミ	探偵オペラ_ミルキィホームズ
クラリス	探偵オペラ_ミルキィホームズ
シャーロック・ホームズ	探偵オペラ_ミルキィホームズ
アイリーン・ドアラー	探偵オペラ_ミルキィホームズ
天城茉莉音	探偵オペラ_ミルキィホームズ
ニコラス	探偵オペラ_ミルキィホームズ
モリアーティ	探偵オペラ_ミルキィホームズ
アモーレ	探偵オペラ_ミルキィホームズ
エラリー姫百合	探偵オペラ_ミルキィホームズ
森・アーティ	探偵オペラ_ミルキィホームズ
ジャンヌ	探偵オペラ_ミルキィホームズ
ネロ・ウルフ	探偵オペラ_ミルキィホームズ
エルキュール・ポアロ	探偵オペラ_ミルキィホームズ
明神川アリス	探偵オペラ_ミルキィホームズ
リズミック	探偵オペラ_ミルキィホームズ
来栖ソニア	探偵オペラ_ミルキィホームズ
パーン	探検ドリランド_-1000年の真宝-
シャッキ	探検ドリランド_-1000年の真宝-
ミコト	探検ドリランド_-1000年の真宝-
高槻よしの	放浪息子
白井桃子	放浪息子
千葉さおり	放浪息子
麻衣子	放浪息子
末広安那	放浪息子
有賀誠	放浪息子
佐々かなこ	放浪息子
瀬谷理久	放浪息子
更科千鶴	放浪息子
二鳥真穂	放浪息子
二宮文弥	放浪息子
ハーン	救命戦士ナノセイバー
中嶋正義	断裁分離のクライムエッジ
病院坂病子	断裁分離のクライムエッジ
病院坂法子	断裁分離のクライムエッジ
皇鼎	断裁分離のクライムエッジ
灰村切	断裁分離のクライムエッジ
エミリー・レッドハンズ	断裁分離のクライムエッジ
武者小路祝	断裁分離のクライムエッジ
美墨かしこ	断裁分離のクライムエッジ
ゴル胡魔193	新ビックリマン
プッチー・オリン	新ビックリマン
ベリー・オズ	新ビックリマン
マコト	新ビックリマン
ヤマトウォーリア	新ビックリマン
メルクリン	新ビックリマン
ディオ・コッキー	新ビックリマン
ジョジョ	新メイプルタウン物語_パームタウン編
シモーヌ	新メイプルタウン物語_パームタウン編
大友譲二	新世紀GPXサイバーフォーミュラ
菅生あすか	新世紀GPXサイバーフォーミュラ
ジャッキー・グーデリアン	新世紀GPXサイバーフォーミュラ
三神刀真	新世紀GPXサイバーフォーミュラ
日吉明	新世紀GPXサイバーフォーミュラ
クレア・フォートラン	新世紀GPXサイバーフォーミュラ
城之内みき	新世紀GPXサイバーフォーミュラ
結城レナ	新世紀GPXサイバーフォーミュラ
フィル・フリッツ	新世紀GPXサイバーフォーミュラ
フランツ・ハイネル	新世紀GPXサイバーフォーミュラ
アンリ・クレイトー	新世紀GPXサイバーフォーミュラ
名雲京志郎	新世紀GPXサイバーフォーミュラ
新条直輝	新世紀GPXサイバーフォーミュラ
ブイハチ	新世紀GPXサイバーフォーミュラ
時田シロウ	新世紀エヴァンゲリオン
碇ゲンドウ	新世紀エヴァンゲリオン
日向マコト	新世紀エヴァンゲリオン
阿賀野カエデ	新世紀エヴァンゲリオン
惣流・キョウコ・ツェッペリン	新世紀エヴァンゲリオン
加持リョウジ	新世紀エヴァンゲリオン
大井サツキ	新世紀エヴァンゲリオン
赤木ナオコ	新世紀エヴァンゲリオン
高雄コウジ	新世紀エヴァンゲリオン
長良スミレ	新世紀エヴァンゲリオン
山岸マユミ	新世紀エヴァンゲリオン
鈴原トウジ	新世紀エヴァンゲリオン
碇ユイ	新世紀エヴァンゲリオン
真希波・マリ・イラストリアス	新世紀エヴァンゲリオン
赤木リツコ	新世紀エヴァンゲリオン
冬月コウゾウ	新世紀エヴァンゲリオン
鈴原サクラ	新世紀エヴァンゲリオン
北上ミドリ	新世紀エヴァンゲリオン
伊吹マヤ	新世紀エヴァンゲリオン
霧島マナ	新世紀エヴァンゲリオン
キール・ローレンツ	新世紀エヴァンゲリオン
ペンペン	新世紀エヴァンゲリオン
洞木ヒカリ	新世紀エヴァンゲリオン
成瀬澪	新妹魔王の契約者
野中胡桃	新妹魔王の契約者
ゼスト	新妹魔王の契約者
ヴァルガ	新妹魔王の契約者
ネブラ	新妹魔王の契約者
フィオ	新妹魔王の契約者
ルキア	新妹魔王の契約者
バルフレア	新妹魔王の契約者
ベルフェゴール	新妹魔王の契約者
野中柚希	新妹魔王の契約者
成瀬万理亜	新妹魔王の契約者
Alex	新機動戦記ガンダムW
雪野弥生	新竹取物語_1000年女王
ハンニバル	新竹取物語_1000年女王
夜森大介	新竹取物語_1000年女王
アクボーン	新造人間キャシャーン
サグレー	新造人間キャシャーン
キャシャーン	新造人間キャシャーン
上月ルナ	新造人間キャシャーン
小西	旋風の用心棒
樹瀬リノ	旦那が何を言っているかわからない件
今日子	旦那が何を言っているかわからない件
忠	旦那が何を言っているかわからない件
カオル	旦那が何を言っているかわからない件
斑鳩あやめ	明日のよいち!
斑鳩いぶき	明日のよいち!
斑鳩かごめ	明日のよいち!
ひろゆき	明日のよいち!
鳥谷恵太	明日のよいち!
鷲津涼	明日のよいち!
まさゆき	明日のよいち!
斑鳩ちはや	明日のよいち!
フランシス・ハーコート	明日のナージャ
二宮忠八	明日のナージャ
ヨハンナ	明日のナージャ
エドナ	明日のナージャ
レイモン	明日のナージャ
コレット	明日のナージャ
シルヴィー・アルテ	明日のナージャ
ホセ・ロドリゲス	明日のナージャ
ローズマリー	明日のナージャ
ケンノスケ・ツルギ	明日のナージャ
フィービー	明日のナージャ
飛田鴻星	星方天使エンジェルリンクス
エイシャ・クランクラン	星方武侠アウトロースター
グエン・カーン	星方武侠アウトロースター
メルフィナ	星方武侠アウトロースター
白石なごみ	星空へ架かる橋
マリアン・ルヴェール	星銃士ビスマルク
プテラ	時空探偵ゲンシクン
大和ソラ	時空探偵ゲンシクン
柏葉さつき	普通の女子校生が【ろこどる】やってみた。
野田硝子	普通の女子校生が【ろこどる】やってみた。
水元美里	普通の女子校生が【ろこどる】やってみた。
鶴木つばさ	普通の女子校生が【ろこどる】やってみた。
伊勢見りのん	普通の女子校生が【ろこどる】やってみた。
キジャ	暁のヨナ
カン・テジュン	暁のヨナ
カン・スジン	暁のヨナ
アン・ジュンギ	暁のヨナ
シンア	暁のヨナ
スウォン	暁のヨナ
ジェハ	暁のヨナ
ヨナ	暁のヨナ
アオ	暁のヨナ
テヨン	暁のヨナ
ミンス	暁のヨナ
榊原蓮	暗殺教室
雪村あぐり	暗殺教室
ケヴィン	暗殺教室
杉野友人	暗殺教室
岡野ひなた	暗殺教室
赤羽業	暗殺教室
原寿美鈴	暗殺教室
イリーナ・イェラビッチ	暗殺教室
寺坂竜馬	暗殺教室
村松拓哉	暗殺教室
磯貝悠馬	暗殺教室
三村航輝	暗殺教室
荒木鉄平	暗殺教室
倉橋陽菜乃	暗殺教室
中村莉桜	暗殺教室
鬼屋敷さくら	暗殺教室
松方	暗殺教室
竹林孝太郎	暗殺教室
鷹岡明	暗殺教室
岡島大河	暗殺教室
神崎有希子	暗殺教室
浅野學峯	暗殺教室
ロヴロ・ブロフスキ	暗殺教室
殺せんせー	暗殺教室
進藤一考	暗殺教室
片岡メグ	暗殺教室
前原陽斗	暗殺教室
速水凛香	暗殺教室
吉田大成	暗殺教室
不破優月	暗殺教室
奥田愛美	暗殺教室
レッドアイ	暗殺教室
烏間惟臣	暗殺教室
菅谷創介	暗殺教室
浅野学秀	暗殺教室
汐風	暴れん坊力士!!松太郎
南令子	暴れん坊力士!!松太郎
梅夫	暴れん坊力士!!松太郎
金城白子	曇天に笑う
曇天火	曇天に笑う
芦屋睦月	曇天に笑う
大木喬任	曇天に笑う
曇宙太郎	曇天に笑う
安倍蒼世	曇天に笑う
佐々木妃子	曇天に笑う
岩倉具視	曇天に笑う
曇空丸	曇天に笑う
バルジャン	最強ロボ_ダイオージャ
ヨシ	最強銀河_究極ゼロ_〜バトルスピリッツ〜
ソルト	最強銀河_究極ゼロ_〜バトルスピリッツ〜
リドル	最強銀河_究極ゼロ_〜バトルスピリッツ〜
ハンソ郎	最強銀河_究極ゼロ_〜バトルスピリッツ〜
ライラ・エイプリル	最強銀河_究極ゼロ_〜バトルスピリッツ〜
リクト・エイプリル	最強銀河_究極ゼロ_〜バトルスピリッツ〜
蟹座のルキノス	最強銀河_究極ゼロ_〜バトルスピリッツ〜
流れ星のキリガ	最強銀河_究極ゼロ_〜バトルスピリッツ〜
マレーネ	最強銀河_究極ゼロ_〜バトルスピリッツ〜
流しのワタリ	最強銀河_究極ゼロ_〜バトルスピリッツ〜
ガルボ	最強銀河_究極ゼロ_〜バトルスピリッツ〜
目覚めのツルハシ	最強銀河_究極ゼロ_〜バトルスピリッツ〜
怒りのハシブト	最強銀河_究極ゼロ_〜バトルスピリッツ〜
獅子座のデネボラ	最強銀河_究極ゼロ_〜バトルスピリッツ〜
明の明星のエリス	最強銀河_究極ゼロ_〜バトルスピリッツ〜
島津	最近、妹のようすがちょっとおかしいんだが。
根子	最近、妹のようすがちょっとおかしいんだが。
都ゆかり	月刊少女野崎くん
御子柴実琴	月刊少女野崎くん
堀政行	月刊少女野崎くん
鈴木三郎	月刊少女野崎くん
宮前剣	月刊少女野崎くん
若松博隆	月刊少女野崎くん
瀬尾結月	月刊少女野崎くん
マミコ	月刊少女野崎くん
前野蜜也	月刊少女野崎くん
香西	月面兎兵器ミーナ
大月	月面兎兵器ミーナ
下鴨矢四郎	有頂天家族
下鴨矢三郎	有頂天家族
赤玉先生	有頂天家族
下鴨矢一郎	有頂天家族
下鴨矢二郎	有頂天家族
夷川早雲	有頂天家族
天津忠明	朝霧の巫女
柊弾児	未来ロボ_ダルタニアス
カマル	未来ロボ_ダルタニアス
かおり	未来ロボ_ダルタニアス
圭太	未来ロボ_ダルタニアス
岸田	未来ロボ_ダルタニアス
ザルバ	未来ロボ_ダルタニアス
クロッペン	未来ロボ_ダルタニアス
元一	未来ロボ_ダルタニアス
ガル	未来少年コナン
モンスリー	未来少年コナン
タイガ	未来少年コナンII_タイガアドベンチャー
優人	未来少年コナンII_タイガアドベンチャー
ソフィア・ニーナ・ローズ	未来警察ウラシマン
桃内まゆら	未確認で進行形
夜ノ森茜	未確認で進行形
三峰真白	未確認で進行形
三峰白夜	未確認で進行形
三峰白雪	未確認で進行形
大野仁子	未確認で進行形
鹿島撫子	未確認で進行形
夜ノ森紅緒	未確認で進行形
末続このは	未確認で進行形
辻仁太郎	東のエデン
森美咲	東のエデン
結城亮	東のエデン
大杉智	東のエデン
春日晴男	東のエデン
平澤一臣	東のエデン
物部大樹	東のエデン
葛原みくる	東のエデン
白鳥・D・黒羽	東のエデン
近藤勇誠	東のエデン
おネエ	東のエデン
黒井小節	東京ESP
江戸山紫	東京ESP
漆葉竜胆	東京ESP
ツインズ	東京ESP
東京太郎	東京ESP
ペギィ	東京ESP
小野沢悠貴	東京マグニチュード8.0
川崎彩	東京マグニチュード8.0
日下部真理	東京マグニチュード8.0
土御門春虎	東京レイヴンズ
早乙女涼	東京レイヴンズ
土御門夜光	東京レイヴンズ
高坂	東京レイヴンズ
角行鬼	東京レイヴンズ
鏡伶路	東京レイヴンズ
大連寺鈴鹿	東京レイヴンズ
大友陣	東京レイヴンズ
木暮禅次朗	東京レイヴンズ
阿刀冬児	東京レイヴンズ
ナキ	東京喰種トーキョーグール
霧嶋董香	東京喰種トーキョーグール
笛口リョーコ	東京喰種トーキョーグール
真戸暁	東京喰種トーキョーグール
掘ちえ	東京喰種トーキョーグール
草場一平	東京喰種トーキョーグール
永近英良	東京喰種トーキョーグール
西尾錦	東京喰種トーキョーグール
法寺項介	東京喰種トーキョーグール
宗太	東京喰種トーキョーグール
金木研	東京喰種トーキョーグール
帆糸ロマ	東京喰種トーキョーグール
西野貴未	東京喰種トーキョーグール
宇井郡	東京喰種トーキョーグール
平子丈	東京喰種トーキョーグール
有馬貴将	東京喰種トーキョーグール
安久黒奈	東京喰種トーキョーグール
真戸呉緒	東京喰種トーキョーグール
滝澤政道	東京喰種トーキョーグール
古間円児	東京喰種トーキョーグール
芳村	東京喰種トーキョーグール
ビッグマダム	東京喰種トーキョーグール
瓶兄弟	東京喰種トーキョーグール
亜門鋼太朗	東京喰種トーキョーグール
鈴屋什造	東京喰種トーキョーグール
松前	東京喰種トーキョーグール
万丈数壱	東京喰種トーキョーグール
入見カヤ	東京喰種トーキョーグール
田口	東京喰種トーキョーグール
丸手斎	東京喰種トーキョーグール
巴輝子	柔道讃歌
巴突進太	柔道讃歌
ナツキ	格闘美神_武龍
大場政夫	格闘美神_武龍
毛蘭	格闘美神_武龍
園田美月	桜Trick
乙川澄	桜Trick
坂井理奈	桜Trick
ジャン・ピエール・レオ	桜蘭高校ホスト部
エリサ	森のトントたち
三浦千尋	森田さんは無口
村越美樹	森田さんは無口
メガネ娘	森田さんは無口
山本りつき	森田さんは無口
ズィータ・ブルザスコ	棺姫のチャイカ
アルベリック・ジレット	棺姫のチャイカ
フレドリカ	棺姫のチャイカ
ニコライ・アフトトル	棺姫のチャイカ
レオナルド・ストーラ	棺姫のチャイカ
マテウス・キャラウェイ	棺姫のチャイカ
アカリ・アキュラ	棺姫のチャイカ
ヴィヴィ・ホロパイネン	棺姫のチャイカ
チャイカ・ボフダーン	棺姫のチャイカ
ギイ	棺姫のチャイカ
佐野杏樹	極上!!めちゃモテ委員長
西崎青	極上!!めちゃモテ委員長
東條潮	極上!!めちゃモテ委員長
テモテモ	極上!!めちゃモテ委員長
坂下リカ	極上!!めちゃモテ委員長
佐藤先生	極上!!めちゃモテ委員長
星野姫香	極上!!めちゃモテ委員長
美村魔子	極上!!めちゃモテ委員長
ユージ	極上!!めちゃモテ委員長
金田利子	極上!!めちゃモテ委員長
朝倉理子	極上!!めちゃモテ委員長
矩継琴葉	極上生徒会
シンディ真鍋	極上生徒会
久川まあち	極上生徒会
銀河久遠	極上生徒会
プッチャン	極上生徒会
桂聖奈	極上生徒会
伊丹ゆきみ	極上生徒会
斗光奈波	極黒のブリュンヒルデ
柱谷小五郎	極黒のブリュンヒルデ
千絵	極黒のブリュンヒルデ
沙織	極黒のブリュンヒルデ
橘佳奈	極黒のブリュンヒルデ
鷹鳥小鳥	極黒のブリュンヒルデ
クロネコ	極黒のブリュンヒルデ
村上良太	極黒のブリュンヒルデ
諸葛亮孔明	横山光輝_三国志
曹操孟徳	横山光輝_三国志
孫策伯符	横山光輝_三国志
典韋	横山光輝_三国志
王允	横山光輝_三国志
関平	横山光輝_三国志
夏侯惇元譲	横山光輝_三国志
李儒	横山光輝_三国志
献帝	横山光輝_三国志
董卓仲穎	横山光輝_三国志
華雄	横山光輝_三国志
趙雲子龍	横山光輝_三国志
周瑜公瑾	横山光輝_三国志
モック	樫の木モック
小林鳩子	機動天使エンジェリックレイヤー
鈴原みさき	機動天使エンジェリックレイヤー
三原王二郎	機動天使エンジェリックレイヤー
ブライアン・ステッグマイヤー	機動戦士ガンダム00
ネフェル・ナギーブ	機動戦士ガンダム00
池田	機動戦士ガンダム00
ホリー・スミルノフ	機動戦士ガンダム00
オネット・コーリー	機動戦士ガンダムAGE
Aisha	機動戦士ガンダムSEED
ヒルダ・ハーケン	機動戦士ガンダムSEED_DESTINY
早乙女美姫	機動新撰組_萌えよ剣_TV
慈慧	機動新撰組_萌えよ剣_TV
沖田薫	機動新撰組_萌えよ剣_TV
土方歳絵	機動新撰組_萌えよ剣_TV
近藤勇子	機動新撰組_萌えよ剣_TV
坂本竜之介	機動新撰組_萌えよ剣_TV
Bobby	機動武闘伝Gガンダム
Sophia	機動武闘伝Gガンダム
フェイロン	機動武闘伝Gガンダム
楠本	機動警察パトレイバー
内海	機動警察パトレイバー
泉野明	機動警察パトレイバー
熊耳武緒	機動警察パトレイバー
平光	機動警察パトレイバー
柘植行人	機動警察パトレイバー
松井孝弘	機動警察パトレイバー
後藤喜一	機動警察パトレイバー
佐久間	機動警察パトレイバー
平田	機動警察パトレイバー
香貫花・クランシー	機動警察パトレイバー
浅沼	機動警察パトレイバー
片岡	機動警察パトレイバー
南雲しのぶ	機動警察パトレイバー
榊清太郎	機動警察パトレイバー
不破環生	機動警察パトレイバー
伊藤博文	機巧奇傳ヒヲウ戦記
清河八郎	機巧奇傳ヒヲウ戦記
坂本竜馬	機巧奇傳ヒヲウ戦記
イシ	機巧奇傳ヒヲウ戦記
キンバリー	機巧少女は傷つかない
シャルロット・ブリュー	機巧少女は傷つかない
クルーエル	機巧少女は傷つかない
赤羽雷真	機巧少女は傷つかない
アンリエット・ブリュー	機巧少女は傷つかない
スティック・バーナード	機甲創世記モスピーダ
ウード	機甲創世記モスピーダ
ロミー	機甲創世記モスピーダ
ブリード	機甲戦記ドラグナー
ギルトール	機甲戦記ドラグナー
リンダ・プラート	機甲戦記ドラグナー
ドルチェノフ	機甲戦記ドラグナー
ウェルナー・フリッツ	機甲戦記ドラグナー
ローズ・パテントン	機甲戦記ドラグナー
パウエル	機甲戦記ドラグナー
ライト・ニューマン	機甲戦記ドラグナー
ジェイコブ	機甲戦記ドラグナー
ハイデルネッケン	機甲戦記ドラグナー
グン・ジェム	機甲戦記ドラグナー
ヒルムカ	機甲界ガリアン
ドン・スラーゼン	機甲界ガリアン
ローダン	機甲界ガリアン
チュルル	機甲界ガリアン
シム	機甲艦隊ダイラガーXV
森川	機甲艦隊ダイラガーXV
ロッシェ	機甲艦隊ダイラガーXV
トロイダル	機甲警察メタルジャック
戸倉	機甲警察メタルジャック
豪田剛	機甲警察メタルジャック
門倉	機甲警察メタルジャック
萩原	機甲警察メタルジャック
メガデス	機甲警察メタルジャック
神代真名	機神大戦ギガンティック・フォーミュラ
天野卯兎美	機神大戦ギガンティック・フォーミュラ
イリス	武装神姫
ヴィクトリア	武装神姫
神堂	武装神姫
クラウディ	武装神姫
ゾーラ	武装神姫
戦部厳至	武装錬金
根来忍	武装錬金
楯山千歳	武装錬金
早坂桜花	武装錬金
ムーンフェイス	武装錬金
太	武装錬金
坂口照星	武装錬金
西山	武装錬金
火渡赤馬	武装錬金
円山円	武装錬金
キャプテンブラボー	武装錬金
岡野	残響のテロル
六笠	残響のテロル
晴香	残響のテロル
羽村	残響のテロル
柴崎健次郎	残響のテロル
木下	残響のテロル
ハイヴ	残響のテロル
ロドリゲス	母をたずねて三千里
マルコ・ロッシ	母をたずねて三千里
パブロ・ガルシア	母をたずねて三千里
ドメニコ	母をたずねて三千里
アンヘル	母をたずねて三千里
ルキーノ	母をたずねて三千里
ルイザ	母をたずねて三千里
ベルナルド	母をたずねて三千里
フェルナンデス	母をたずねて三千里
井川	水色時代
河合優子	水色時代
ミト・カヤ	氷河戦士ガイスラッガー
増田	波打際のむろみさん
宝満さん	波打際のむろみさん
内山夕実	洲崎西_THE_ANIMATION
西明日香	洲崎西_THE_ANIMATION
洲崎綾	洲崎西_THE_ANIMATION
花園勇花	浦安鉄筋家族
野村幸子	浦安鉄筋家族
大沢木大鉄	浦安鉄筋家族
大沢木桜	浦安鉄筋家族
春巻龍	浦安鉄筋家族
上田信彦	浦安鉄筋家族
西川のり子	浦安鉄筋家族
山崎民子	浦安鉄筋家族
菊池あかね	浦安鉄筋家族
花園垣	浦安鉄筋家族
ジェム	海のトリトン
ルカー	海のトリトン
千絵子	海月姫
鯉淵修	海月姫
鯉淵蔵之介	海月姫
オクトパス	海賊王子
クラップ	海賊王子
ドラゴ	深海伝説MEREMANOID
ジョゼ	深海伝説MEREMANOID
古雅葵	満月をさがして
めろこ・ユイ	満月をさがして
若松円	満月をさがして
いずみ・リオ	満月をさがして
桜井英知	満月をさがして
金龍大	激闘!クラッシュギアTURBO
迅キョウスケ	激闘!クラッシュギアTURBO
ゴッドママ	激闘!クラッシュギアTURBO
王虎	激闘!クラッシュギアTURBO
スミカ	灰羽連盟
ショータ	灰羽連盟
クウ	灰羽連盟
中村公子	灼眼のシャナ
吉田健	灼眼のシャナ
高井	灼眼のシャナ
坂井悠二	灼眼のシャナ
ユストゥス	灼眼のシャナ
池速人	灼眼のシャナ
近藤	灼眼のシャナ
シャナたん	灼眼のシャナ
インデックスたん	灼眼のシャナ
平井ゆかり	灼眼のシャナ
シャナ	灼眼のシャナ
荒木村重	炎の蜃気楼
門脇綾子	炎の蜃気楼
千秋修平	炎の蜃気楼
仰木高耶	炎の蜃気楼
北条氏照	炎の蜃気楼
高坂弾正	炎の蜃気楼
直江信綱	炎の蜃気楼
成田譲	炎の蜃気楼
藤堂みさと	炎の闘球児_ドッジ弾平
一撃弾平	炎の闘球児_ドッジ弾平
白川晶	炎の闘球児_ドッジ弾平
五十嵐剛	炎の闘球児_ドッジ弾平
二階堂大河	炎の闘球児_ドッジ弾平
三笠	炎の闘球児_ドッジ弾平
マリー	烈火の炎
辰子	烈火の炎
羊子	烈火の炎
空海	烈火の炎
卯美	烈火の炎
佐古下柳	烈火の炎
犬子	烈火の炎
最澄	烈火の炎
麗奈	烈火の炎
亜希	烈火の炎
火車丸	烈火の炎
サヴァイヴ	無人惑星サヴァイヴ
ハワード	無人惑星サヴァイヴ
シャアラ	無人惑星サヴァイヴ
シンゴ	無人惑星サヴァイヴ
メノリ	無人惑星サヴァイヴ
熊枕久瑠美	無彩限のファントム・ワールド
一条晴彦	無彩限のファントム・ワールド
和泉玲奈	無彩限のファントム・ワールド
水無瀬小糸	無彩限のファントム・ワールド
姫野アリス	無彩限のファントム・ワールド
川神舞	無彩限のファントム・ワールド
アルブレヒト	無彩限のファントム・ワールド
足立	無敵ロボトライダーG7
山田アキラ	無敵ロボトライダーG7
鈴木三重子	無敵ロボトライダーG7
京鞍馬	無敵王トライゼノン
樹雫	無敵王トライゼノン
甲斐童夢	無敵王トライゼノン
鬼丸美輝	無敵看板娘
西山勘九郎	無敵看板娘
敏行	無敵看板娘
神無月めぐみ	無敵看板娘
和子	無敵超人ザンボット3
浜本	無敵超人ザンボット3
神北兵左衛門	無敵超人ザンボット3
チーコ	無敵超人ザンボット3
香月真吾	無敵超人ザンボット3
政吉	無敵超人ザンボット3
林	無敵超人ザンボット3
ドン・ザウサー	無敵鋼人ダイターン3
コロス	無敵鋼人ダイターン3
ビューティフル・タチバナ	無敵鋼人ダイターン3
三条レイカ	無敵鋼人ダイターン3
ラッド	無敵鋼人ダイターン3
ユリコ・スター	無責任艦長タイラー
シア・ハス	無責任艦長タイラー
マコト・ヤマモト	無責任艦長タイラー
ル・バラバ・ドム	無責任艦長タイラー
ミッキー・クライバーン	無責任艦長タイラー
カール・ビョルン・アンドレセン	無責任艦長タイラー
キョンファ・キム	無責任艦長タイラー
コジロー・サカイ	無責任艦長タイラー
尾瀬イクミ	無限のリヴァイアス
ユイリィ・バハナ	無限のリヴァイアス
ルクスン・北条	無限のリヴァイアス
ネーヤ	無限のリヴァイアス
蓬仙あおい	無限のリヴァイアス
相葉祐希	無限のリヴァイアス
エリック・キャンベル	無限のリヴァイアス
エアーズ・ブルー	無限のリヴァイアス
ファイナ・S・篠崎	無限のリヴァイアス
クリフ・ケイ	無限のリヴァイアス
シュタイン・ヘイガー	無限のリヴァイアス
和泉こずえ	無限のリヴァイアス
ユウマ	無限戦記ポトリス
オネイダ	無限戦記ポトリス
オルデン	無限戦記ポトリス
フロイド	無限戦記ポトリス
トルーパー	無限戦記ポトリス
町口	無限戦記ポトリス
黒柳亮	焼きたて!!ジャぱん
出川哲朗	焼きたて!!ジャぱん
霧崎雄一	焼きたて!!ジャぱん
模糊山剛	焼きたて!!ジャぱん
服部幸應	焼きたて!!ジャぱん
冠茂	焼きたて!!ジャぱん
松代健	焼きたて!!ジャぱん
諏訪原戒	焼きたて!!ジャぱん
三木のり平	焼きたて!!ジャぱん
シャドウ・ホワイト	焼きたて!!ジャぱん
松代楓	焼きたて!!ジャぱん
マイスター霧崎	焼きたて!!ジャぱん
梓川水乃	焼きたて!!ジャぱん
河内恭介	焼きたて!!ジャぱん
ソフィ・バルザック・霧崎	焼きたて!!ジャぱん
キャシー	焼きたて!!ジャぱん
電気王	熱血最強ゴウザウラー
エンジン王	熱血最強ゴウザウラー
歯車王	熱血最強ゴウザウラー
ロッキー羽田	燃える!お兄さん
火堂害	燃える!お兄さん
レーク	爆れつハンター
マーゴ	爆れつハンター
レーヌ	爆れつハンター
ドーター	爆れつハンター
ファビア・シーン	爆丸バトルブローラーズ
ジェイク・ヴァレリ	爆丸バトルブローラーズ
カザリナ	爆丸バトルブローラーズ
エイザン・グリン	爆丸バトルブローラーズ
ミラ・フェルミン	爆丸バトルブローラーズ
ジュリィ・ヘイワード	爆丸バトルブローラーズ
シャドウ・プローヴ	爆丸バトルブローラーズ
スペクトラ・ファントム	爆丸バトルブローラーズ
ラインハルト	爆丸バトルブローラーズ
マスカレード	爆丸バトルブローラーズ
イングラム	爆丸バトルブローラーズ
ビリー・ギルバート	爆丸バトルブローラーズ
サイクロプス	爆丸バトルブローラーズ
ナザック	爆丸バトルブローラーズ
クラウス・フォン・ヘルゼン	爆丸バトルブローラーズ
リーナ・アイシス	爆丸バトルブローラーズ
城治	爆丸バトルブローラーズ
タツヤ	爆丸バトルブローラーズ
ギル	爆丸バトルブローラーズ
シド・アーカイル	爆丸バトルブローラーズ
シャーマン	爆丸バトルブローラーズ
ブルース・ブラウン	爆丸バトルブローラーズ
アリス・ゲーハビッチ	爆丸バトルブローラーズ
ゼネット・シローネ	爆丸バトルブローラーズ
美咲琉乃	爆丸バトルブローラーズ
プリンス・ハイドロン	爆丸バトルブローラーズ
エアゼル	爆丸バトルブローラーズ
丸蔵兆治	爆丸バトルブローラーズ
スコーティア	爆丸バトルブローラーズ
キマイラ	爆丸バトルブローラーズ
チャン・リー	爆丸バトルブローラーズ
リンク・ボラン	爆丸バトルブローラーズ
ミレーヌ・ファロウ	爆丸バトルブローラーズ
バロン・リッチ	爆丸バトルブローラーズ
レン・クロウラー	爆丸バトルブローラーズ
エルフィン	爆丸バトルブローラーズ
バリオディウス	爆丸バトルブローラーズ
ヴォルト・ラスター	爆丸バトルブローラーズ
ガス・グラヴ	爆丸バトルブローラーズ
ディアブロ	爆丸バトルブローラーズ
ヴェガ	爆丸バトルブローラーズ
風見駿	爆丸バトルブローラーズ
蔵木コドウ	爆球Hit!_クラッシュビーダマン
仙堂ナナ	爆球Hit!_クラッシュビーダマン
政雄	爆球Hit!_クラッシュビーダマン
神岡テルマ	爆球Hit!_クラッシュビーダマン
荒崎キョウスケ	爆球Hit!_クラッシュビーダマン
哲三	爆裂天使
洋子	爆裂天使
アンジェリーク	爆裂天使
ウィリアム・テル	爆闘宣言ダイガンダー
曙アキラ	爆闘宣言ダイガンダー
ジーコ	牙_-KIBA-
チャベス	牙_-KIBA-
ロイア	牙_-KIBA-
ヒュー	牙_-KIBA-
キーラ	牙_-KIBA-
メンドーサ	牙狼-GARO-_-炎の刻印-
レオン・ルイス	牙狼-GARO-_-炎の刻印-
ガルシア	牙狼-GARO-_-炎の刻印-
ラウラ	牙狼-GARO-_-炎の刻印-
ガルム	牙狼-GARO-_-炎の刻印-
セルマ	牧場の少女カトリ
アリーナ	牧場の少女カトリ
アベル	牧場の少女カトリ
トポル	牧場の少女カトリ
ラスキ	牧場の少女カトリ
無限真人	特装機兵ドルバック
大澤映見	犬とハサミは使いよう
犬飼潔	犬とハサミは使いよう
柊鈴菜	犬とハサミは使いよう
姫萩紅葉	犬とハサミは使いよう
春海和人	犬とハサミは使いよう
秋月マキシ	犬とハサミは使いよう
竜骨精	犬夜叉
刀々斎	犬夜叉
霧骨	犬夜叉
紫織	犬夜叉
殺生丸の母	犬夜叉
逆髪の結羅	犬夜叉
犬夜叉の父	犬夜叉
睡骨	犬夜叉
殺生丸	犬夜叉
煉骨	犬夜叉
犬夜叉の母	犬夜叉
蛇骨	犬夜叉
魍魎丸	犬夜叉
甘利信長	犬夜叉
人見蔭刀	犬夜叉
銀骨	犬夜叉
白心上人	犬夜叉
白童子	犬夜叉
老狼	犬夜叉
死神鬼	犬夜叉
杜松美希音	犬神さんと猫山さん
猿飛空	犬神さんと猫山さん
猫山珠喜	犬神さんと猫山さん
鳥飼ひばり	犬神さんと猫山さん
猫山鈴	犬神さんと猫山さん
乱崎銀夏	狂乱家族日記
ミケランジェロ	狂乱家族日記
乱崎千花	狂乱家族日記
死神三番	狂乱家族日記
乱崎雹霞	狂乱家族日記
竜骨寺椿姫	狂乱家族日記
乱崎凰火	狂乱家族日記
乱崎月香	狂乱家族日記
鷹縁切子	狂乱家族日記
デカメロン	狂乱家族日記
乱崎帝架	狂乱家族日記
乱崎優歌	狂乱家族日記
ノーラ・アレント	狼と香辛料
エーブ・ボラン	狼と香辛料
クロエ	狼と香辛料
ワイズ	狼と香辛料
ホロ	狼と香辛料
ウォーリー	狼少年ケン
白崎蓮美	猫神やおよろず
正倉院笹鳴	猫神やおよろず
鎮葉御前	猫神やおよろず
賀茂雪那	猫神やおよろず
ツクヨミ	猫神やおよろず
古宮柚子	猫神やおよろず
枕木夕楽々	猫神やおよろず
新九郎	獣兵衛忍風帖
鉄斎	獣兵衛忍風帖
ジェントル	獣戦士ガルキーバ
トラッシュ	獣戦士ガルキーバ
ヒューリー	獣旋バトル_モンスーノ
ペトロス	獣旋バトル_モンスーノ
ドレッズ	獣旋バトル_モンスーノ
メディーア	獣旋バトル_モンスーノ
ハーグレイヴ	獣旋バトル_モンスーノ
ドルーグ	獣旋バトル_モンスーノ
チェン	獣王星
クライン	獣王星
イヴァ	獣王星
ティズ	獣王星
真一	獣神ライガー
ドル・ガイスト	獣神ライガー
リュウ・ドルク	獣神ライガー
村川	獣神ライガー
史明	獣神演武_-HERO_TALES-
森谷ヒヨリ	琴浦さん
琴浦春香	琴浦さん
室戸大智	琴浦さん
琴浦久美子	琴浦さん
御舟百合子	琴浦さん
津山	琴浦さん
琴浦善三	琴浦さん
真鍋義久	琴浦さん
たまちゃん	瓶詰妖精
ちりり	瓶詰妖精
ワニピー	甘城ブリリアントパーク
栗栖隆也	甘城ブリリアントパーク
土田香苗	甘城ブリリアントパーク
可児江西也	甘城ブリリアントパーク
モッフル	甘城ブリリアントパーク
中城椎菜	甘城ブリリアントパーク
安達映子	甘城ブリリアントパーク
伴藤美衣乃	甘城ブリリアントパーク
藤堂リリシア	生徒会の一存
水無瀬流南	生徒会の一存
残響死滅	生徒会の一存
藤堂エリス	生徒会の一存
紅葉知弦	生徒会の一存
桜野くりむ	生徒会の一存
松原飛鳥	生徒会の一存
杉崎林檎	生徒会の一存
椎名深夏	生徒会の一存
宇宙巡	生徒会の一存
椎名真冬	生徒会の一存
中目黒善樹	生徒会の一存
小山	生徒会役員共
五十嵐カエデ	生徒会役員共
古谷	生徒会役員共
道下	生徒会役員共
バビ	甲虫王者ムシキング_森の民の伝説
ポポ	甲虫王者ムシキング_森の民の伝説
グルム	甲虫王者ムシキング_森の民の伝説
ソーマ	甲虫王者ムシキング_森の民の伝説
デューク	甲虫王者ムシキング_森の民の伝説
パム	甲虫王者ムシキング_森の民の伝説
ブー	甲虫王者ムシキング_森の民の伝説
アダー	甲虫王者ムシキング_森の民の伝説
ペレ	甲虫王者ムシキング_森の民の伝説
りんごちゃん	男子高校生の日常
修一	男子高校生の日常
副会長	男子高校生の日常
ユウスケ	男子高校生の日常
奈古さん	男子高校生の日常
清彦	男子高校生の日常
生島	男子高校生の日常
絵美	男子高校生の日常
唐沢としゆき	男子高校生の日常
ヤナギン	男子高校生の日常
ラバーシューター	男子高校生の日常
羽原	男子高校生の日常
九鬼円	異能バトルは日常系のなかで
姫木千冬	異能バトルは日常系のなかで
神崎灯代	異能バトルは日常系のなかで
櫛川鳩子	異能バトルは日常系のなかで
安藤寿来	異能バトルは日常系のなかで
高梨舞矢	異能バトルは日常系のなかで
高梨彩弓	異能バトルは日常系のなかで
トップジョイ	疾風!アイアンリーガー
極十郎太	疾風!アイアンリーガー
ブルアーマー	疾風!アイアンリーガー
シルキー	疾風!アイアンリーガー
メッケル	疾風!アイアンリーガー
アルカード	疾風!アイアンリーガー
サーティーン	疾風!アイアンリーガー
キアイリュウケン	疾風!アイアンリーガー
ギャレット	疾風!アイアンリーガー
スーパーヘッド	疾風!アイアンリーガー
ナルト	発明BOYカニパン
スズシロ・サオリ	白銀の意思_アルジェヴォルン
シオノ・カオル	白銀の意思_アルジェヴォルン
ナンジョウ・レイカ	白銀の意思_アルジェヴォルン
カイエン・トシカズ	白銀の意思_アルジェヴォルン
ジェイミー・ハザフォード	白銀の意思_アルジェヴォルン
シーカー	白銀の意思_アルジェヴォルン
サモンジ・ウキョウ	白銀の意思_アルジェヴォルン
ソラノ・アカネ	白銀の意思_アルジェヴォルン
テライ・アキノ	白銀の意思_アルジェヴォルン
リチャード王子	白雪姫の伝説
白鯨	白鯨伝説
オハラ	白鯨伝説
アトレ	白鯨伝説
ゴブラ	百獣王ゴライオン
シンクライン皇太子	百獣王ゴライオン
ファーラ姫	百獣王ゴライオン
荒木又右衛門	百花繚乱_SAMURAI_GIRLS
横山杏子	監獄学園
緑川花	監獄学園
栗原万里	監獄学園
白木芽衣子	監獄学園
栗原千代	監獄学園
竹ノ宮ケイト	監獄学園
横山みつ子	監獄学園
トリスタン	真マジンガー_衝撃!_Z編
暗黒大将軍	真マジンガー_衝撃!_Z編
剣鉄也	真マジンガー_衝撃!_Z編
錦織つばさ	真マジンガー_衝撃!_Z編
兜剣造	真マジンガー_衝撃!_Z編
兜十蔵	真マジンガー_衝撃!_Z編
タカジョー・ゼット	真・女神転生デビチル
亜美	真・女神転生デビチル
パイモン	真・女神転生デビチル
レナ	真・女神転生デビチル
ジャックフロスト	真・女神転生デビチル
ネメア	真・女神転生デビチル
アズラエル	真・女神転生デビチル
フェンリル	真・女神転生デビチル
白龍	真拳伝説タイトロード
サラ・ジョーンズ	真拳伝説タイトロード
黒龍	真拳伝説タイトロード
グレン	真拳伝説タイトロード
奈々子	石田とあさくら
朝霧純子	砂ぼうず
魎皇鬼	砂沙美☆魔法少女クラブ
南波テル	破裏拳ポリマー
鎧武士	破裏拳ポリマー
地堂仁美	破邪巨星Gダンガイオー
ミア・アリス	破邪巨星Gダンガイオー
海潮真波	破邪巨星Gダンガイオー
気光子氷ミコ	祝!(ハピ☆ラキ)ビックリマン
聖	祝!(ハピ☆ラキ)ビックリマン
ピア・マルコ	祝!(ハピ☆ラキ)ビックリマン
聖モイラッキー	祝!(ハピ☆ラキ)ビックリマン
天児	祝!(ハピ☆ラキ)ビックリマン
サタンマリア	祝!(ハピ☆ラキ)ビックリマン
シャーマンカーン	祝!(ハピ☆ラキ)ビックリマン
バルドル・フリングホルニ	神々の悪戯
ディオニュソス・テュルソス	神々の悪戯
戸塚陽	神々の悪戯
ロキ・レーヴァテイン	神々の悪戯
ハデス・アイドネウス	神々の悪戯
戸塚月人	神々の悪戯
トール・メギンギヨルズ	神々の悪戯
アヌビス・マアト	神々の悪戯
ゼウス・ケラウノス	神々の悪戯
戸塚尊	神々の悪戯
アポロン・アガナ・ベレア	神々の悪戯
トト・カドゥケウス	神々の悪戯
パロット	神さまのいない日曜日
ユート	神さまのいない日曜日
ヨーキ	神さまのいない日曜日
スフィア	神さまのいない日曜日
アイ・アスティン	神さまのいない日曜日
歩美	神のみぞ知るセカイ
桂木麻里	神のみぞ知るセカイ
美生	神のみぞ知るセカイ
杉本四葉	神のみぞ知るセカイ
浅間亮	神のみぞ知るセカイ
ちひろ	神のみぞ知るセカイ
エリュシア・デ・ルート・イーマ	神のみぞ知るセカイ
純	神のみぞ知るセカイ
怒野モブ子	神のみぞ知るセカイ
寺田京	神のみぞ知るセカイ
石切いづみ	神のみぞ知るセカイ
丸井雪枝	神のみぞ知るセカイ
ユータ	神のみぞ知るセカイ
コウ・ヤガミ	神八剣伝
ヨギ	神撃のバハムート_GENESIS
ティナ	神撃のバハムート_GENESIS
リタ	神撃のバハムート_GENESIS
リザ	神撃のバハムート_GENESIS
フィーナ	神撃のバハムート_GENESIS
アークエンジェル	神撃のバハムート_GENESIS
ファバロ・レオーネ	神撃のバハムート_GENESIS
ルシフェル	神撃のバハムート_GENESIS
アイテール	神撃のバハムート_GENESIS
ケルベロス	神撃のバハムート_GENESIS
ジャンヌ・ダルク	神撃のバハムート_GENESIS
ラスティ	神撃のバハムート_GENESIS
アーミラ	神撃のバハムート_GENESIS
オリヴィエ	神撃のバハムート_GENESIS
ティア	神撃のバハムート_GENESIS
ナイトメア	神撃のバハムート_GENESIS
シルヴィア	神撃のバハムート_GENESIS
ミリアム	神撃のバハムート_GENESIS
カイザル・リドファルド	神撃のバハムート_GENESIS
ニコール	神撃のバハムート_GENESIS
ヴァンピィ	神撃のバハムート_GENESIS
プリス	神撃のバハムート_GENESIS
リーシャ	神撃のバハムート_GENESIS
ミゲル	神撃のバハムート_GENESIS
ベビーフェルパー	神撃のバハムート_GENESIS
花田勝	神様のメモ帳
平坂錬次	神様のメモ帳
岩男	神様のメモ帳
ヨシキ	神様のメモ帳
藤島鳴海	神様のメモ帳
龍王・宿儺	神様はじめました
猫田あみ	神様はじめました
桃園奈々生	神様はじめました
裏嶋小太郎	神様はじめました
巴衛	神様はじめました
翠郎	神様はじめました
悪羅王	神様はじめました
磯姫	神様はじめました
鬼切	神様はじめました
鳴神姫	神様はじめました
助六	神様はじめました
小比類巻	神様はじめました
瑞希	神様はじめました
史場日々乃	神様ドォルズ
藤間	神様ドォルズ
杣木靄子	神様ドォルズ
日向まひる	神様ドォルズ
日向桐生	神様ドォルズ
日向勾司朗	神様ドォルズ
綾女	神様ドォルズ
空張久羽子	神様ドォルズ
小森久美子	神様家族
テンコ	神様家族
マコちゃん	神無月の巫女
乙羽	神無月の巫女
ミヤコ	神無月の巫女
アメノムラクモ	神無月の巫女
ツバサ	神無月の巫女
ルーン・ヴェーナス	神秘の世界エルハザード
ナハト	神秘の世界エルハザード
ディーバ	神秘の世界エルハザード
大神姫子	神霊狩/GHOST_HOUND
鈴木誠一	神霊狩/GHOST_HOUND
東大寺都	神風怪盗ジャンヌ
アクセス・タイム	神風怪盗ジャンヌ
春田	神風怪盗ジャンヌ
ミスト	神風怪盗ジャンヌ
冬田	神風怪盗ジャンヌ
夏田	神風怪盗ジャンヌ
東大寺氷室	神風怪盗ジャンヌ
影丸	神魂合体ゴーダンナー!!
森本	神魂合体ゴーダンナー!!
堀井	神魂合体ゴーダンナー!!
柳沢	神魂合体ゴーダンナー!!
エカテリーナ	神魂合体ゴーダンナー!!
藤村静流	神魂合体ゴーダンナー!!
ルウ・ルー	神魂合体ゴーダンナー!!
芝草	神魂合体ゴーダンナー!!
杉山	神魂合体ゴーダンナー!!
初芝	私がモテないのはどう考えてもお前らが悪い!
黒木智貴	私がモテないのはどう考えてもお前らが悪い!
今江恵美	私がモテないのはどう考えてもお前らが悪い!
青松	私がモテないのはどう考えてもお前らが悪い!
清田	私がモテないのはどう考えてもお前らが悪い!
小坂	私がモテないのはどう考えてもお前らが悪い!
ゆうちゃん	私がモテないのはどう考えてもお前らが悪い!
岡田	私がモテないのはどう考えてもお前らが悪い!
エミリー	私のあしながおじさん
サディ	私のあしながおじさん
メアリー・ランバート	私のあしながおじさん
トミー	私のあしながおじさん
エルザ	私のあしながおじさん
白鳥のジュン	科学忍者隊ガッチャマンF
エリック・ジョーンズ	科学救助隊テクノボイジャー
ミソラ・ホイットテール	空戦魔導士候補生の教官
カナタ・エイジ	空戦魔導士候補生の教官
クロエ・セヴェニー	空戦魔導士候補生の教官
レクティ・アイゼナッハ	空戦魔導士候補生の教官
ユーリ・フロストル	空戦魔導士候補生の教官
喪黒福造	笑ゥせぇるすまん
ジオ・インザーギ	精霊使いの剣舞
フィアナ・レイ・オルデシア	精霊使いの剣舞
グレイワース・シェルマイス	精霊使いの剣舞
エスト	精霊使いの剣舞
レスティア・アッシュドール	精霊使いの剣舞
エルサ	精霊使いの剣舞
草間野分	純情ロマンチカ
宇佐見春彦	純情ロマンチカ
高橋孝浩	純情ロマンチカ
高槻忍	純情ロマンチカ
伊集院響	純情ロマンチカ
宇佐見薫子	純情ロマンチカ
津森	純情ロマンチカ
角圭一	純情ロマンチカ
高橋美咲	純情ロマンチカ
朝比奈薫	純情ロマンチカ
上條弘樹	純情ロマンチカ
宮城庸	純情ロマンチカ
相川絵理	純情ロマンチカ
高槻理沙子	純情ロマンチカ
宇佐見冬彦	純情ロマンチカ
ビブ	純潔のマリア
アルテミス	純潔のマリア
エゼキエル	純潔のマリア
ベルナール	純潔のマリア
一瀬グレン	終わりのセラフ
君月士方	終わりのセラフ
柊暮人	終わりのセラフ
レーネ・シム	終わりのセラフ
クルル・ツェペシ	終わりのセラフ
柊真昼	終わりのセラフ
柊深夜	終わりのセラフ
百夜ミカエラ	終わりのセラフ
早乙女与一	終わりのセラフ
クローリー・ユースフォード	終わりのセラフ
ラクス・ウェルト	終わりのセラフ
フェリド・バートリー	終わりのセラフ
雪見時雨	終わりのセラフ
相原あい子	終わりのセラフ
三宮三葉	終わりのセラフ
百夜優一郎	終わりのセラフ
十条美十	終わりのセラフ
犬吠埼樹	結城友奈は勇者である
乃木園子	結城友奈は勇者である
犬吠埼風	結城友奈は勇者である
三好夏凜	結城友奈は勇者である
義輝	結城友奈は勇者である
シエ	絢爛舞踏祭_ザ・マーズ・デイブレイク
アボット	絢爛舞踏祭_ザ・マーズ・デイブレイク
セレナ	絢爛舞踏祭_ザ・マーズ・デイブレイク
MAKI	絢爛舞踏祭_ザ・マーズ・デイブレイク
アーニャ	絢爛舞踏祭_ザ・マーズ・デイブレイク
ちゃむらい	絶体絶命でんぢゃらすじーさん
りゅぬぁってゃ	絶体絶命でんぢゃらすじーさん
ゲベ	絶体絶命でんぢゃらすじーさん
星村潤一郎	絶園のテンペスト
不破愛花	絶園のテンペスト
鎖部葉風	絶園のテンペスト
不破真広	絶園のテンペスト
ヒロユキ	絶園のテンペスト
鎖部夏村	絶園のテンペスト
エヴァンジェリン山本	絶園のテンペスト
鎖部哲馬	絶園のテンペスト
鎖部左門	絶園のテンペスト
早河巧	絶園のテンペスト
羽村めぐむ	絶園のテンペスト
玉置カズラ	絶対可憐チルドレン
パティ・クルー	絶対可憐チルドレン
朝風理沙	絶対可憐チルドレン
綾崎ハヤテ	絶対可憐チルドレン
真木司郎	絶対可憐チルドレン
火野カガリ	絶対可憐チルドレン
藤浦葉	絶対可憐チルドレン
花菱美希	絶対可憐チルドレン
マサラ	絶対可憐チルドレン
早乙女英治	絶対可憐チルドレン
セラ	絶対可憐チルドレン
加納紅葉	絶対可憐チルドレン
犬神初	絶対可憐チルドレン
筑紫澪	絶対可憐チルドレン
桂ヒナギク	絶対可憐チルドレン
海野潮音	絶対少年
深山美紀	絶対少年
深山美玖	絶対少年
タルト	絶対少年
わっくん	絶対少年
山口梢	絶対無敵ライジンオー
エルドラン	絶対無敵ライジンオー
真野美紀	絶対無敵ライジンオー
佐藤大介	絶対無敵ライジンオー
春野きらら	絶対無敵ライジンオー
ゴクドー	絶対無敵ライジンオー
栗木容子	絶対無敵ライジンオー
高森ひろし	絶対無敵ライジンオー
島田愛子	絶対無敵ライジンオー
池田れいこ	絶対無敵ライジンオー
小島勉	絶対無敵ライジンオー
内田	絶対無敵ライジンオー
皇帝ワルーサ	絶対無敵ライジンオー
タイダー	絶対無敵ライジンオー
ベルゼブ	絶対無敵ライジンオー
バハムート	絶対防衛レヴィアタン
ヨルムンガンド	絶対防衛レヴィアタン
レヴィアタン	絶対防衛レヴィアタン
中空知美咲	緋弾のアリア
島麒麟	緋弾のアリア
高千穂麗	緋弾のアリア
佐々木志乃	緋弾のアリア
風魔陽菜	緋弾のアリア
武藤剛気	緋弾のアリア
不知火亮	緋弾のアリア
間宮あかり	緋弾のアリア
峰理子	緋弾のアリア
神崎・H・アリア	緋弾のアリア
エル・ワトソン	緋弾のアリア
星伽白雪	緋弾のアリア
火野ライカ	緋弾のアリア
鬼崎拓磨	緋色の欠片
瑛子	緋色の欠片
隠岐秋房	緋色の欠片
狗谷志郎	緋色の欠片
空疎尊	緋色の欠片
羅門	緋色の欠片
鬼崎刀真	緋色の欠片
秋篠古嗣	緋色の欠片
大蛇凌	緋色の欠片
鴉取駿	緋色の欠片
悪路王	緋色の欠片
加奈	緋色の欠片
胡土前	緋色の欠片
犬戒響	緋色の欠片
狐邑祐一	緋色の欠片
幻灯火	緋色の欠片
藤森沙弥	緋色の欠片
朝倉景健	織田信奈の野望
真柄直澄	織田信奈の野望
松平元康	織田信奈の野望
木下藤吉郎	織田信奈の野望
ルイズ・フロイス	織田信奈の野望
斎藤義龍	織田信奈の野望
林通勝	織田信奈の野望
蜂須賀五右衛門	織田信奈の野望
朝倉義景	織田信奈の野望
前田犬千代	織田信奈の野望
土田御前	織田信奈の野望
相良良晴	織田信奈の野望
斎藤道三	織田信奈の野望
信楽	繰繰れ!_コックリさん
京極万太郎	美味しんぼ
すみ子	美味しんぼ
輝子	美味しんぼ
冬美	美味しんぼ
鈴子	美味しんぼ
ジェフ・ラーソン	美味しんぼ
テルエ	美味しんぼ
テルコ	美味しんぼ
富二郎	美味しんぼ
海原雄山	美味しんぼ
アーサー・ブラウン	美味しんぼ
唐山陶人	美味しんぼ
熊田雄一郎	美少女戦士セーラームーン
古幡宇奈月	美少女戦士セーラームーン
月野進悟	美少女戦士セーラームーン
西村レイカ	美少女戦士セーラームーン
海野ぐりお	美少女戦士セーラームーン
セーラースターファイター	美少女戦士セーラームーン
桃原桃子	美少女戦士セーラームーン
セーラーパラス	美少女戦士セーラームーン
魔界樹	美少女戦士セーラームーン
浅沼一等	美少女戦士セーラームーン
カタリナ	美少女戦士セーラームーン
更科九助	美少女戦士セーラームーン
大阪なる	美少女戦士セーラームーン
セーラーセレス	美少女戦士セーラームーン
セーラーベスタ	美少女戦士セーラームーン
浦和良	美少女戦士セーラームーン
ゆみこ	美少女戦士セーラームーン
セーラージュノー	美少女戦士セーラームーン
箱根強羅	美男高校地球防衛部LOVE!
ズンダー	美男高校地球防衛部LOVE!
アージェント	美男高校地球防衛部LOVE!
真行寺耕太	美鳥の日々
沢村正治	美鳥の日々
沢村凛	美鳥の日々
ジゴロウ	美鳥の日々
藤田信吉	義風堂々!!_兼続と慶次
井伊直政	義風堂々!!_兼続と慶次
お船	義風堂々!!_兼続と慶次
権左	義風堂々!!_兼続と慶次
直江景綱	義風堂々!!_兼続と慶次
北条氏規	義風堂々!!_兼続と慶次
上杉景勝	義風堂々!!_兼続と慶次
リーマ	翠星のガルガンティア
リジット	翠星のガルガンティア
アレリア	翠星のガルガンティア
ライアン・マツモト	翠星のガルガンティア
ピニオン	翠星のガルガンティア
ベローズ	翠星のガルガンティア
エイミー	翠星のガルガンティア
ベベル	翠星のガルガンティア
オルダム	翠星のガルガンティア
ストーリア	翠星のガルガンティア
ラケージ	翠星のガルガンティア
メルティ	翠星のガルガンティア
フェアロック	翠星のガルガンティア
クーゲル	翠星のガルガンティア
パリヌリ	翠星のガルガンティア
サーヤ	翠星のガルガンティア
パラエム	翠星のガルガンティア
リタ・フォード	聖ルミナス女学院
エリザベス良子ブライアン	聖ルミナス女学院
エレーナ・アルシャヴィナ	聖剣使いの禁呪詠唱
百地春鹿	聖剣使いの禁呪詠唱
アンジェラ・ジョンソン	聖剣使いの禁呪詠唱
嵐城サツキ	聖剣使いの禁呪詠唱
灰村諸葉	聖剣使いの禁呪詠唱
田中太郎	聖剣使いの禁呪詠唱
カワッセ・グー	聖戦士ダンバイン
ゼット・ライト	聖戦士ダンバイン
ピネガン・ハンム	聖戦士ダンバイン
キブツ・キッス	聖戦士ダンバイン
エル・フィノ	聖戦士ダンバイン
パットフット・ハンム	聖戦士ダンバイン
エイブ・タマリ	聖戦士ダンバイン
シルキー・マウ	聖戦士ダンバイン
ベル・アール	聖戦士ダンバイン
ジャバ	聖戦士ダンバイン
水瀬文奈	聖痕のクェイサー
及川麗	聖痕のクェイサー
山辺燈	聖痕のクェイサー
フール	聖痕のクェイサー
仙道六実	聖痕のクェイサー
辻堂美由梨	聖痕のクェイサー
織部まふゆ	聖痕のクェイサー
エリザベス	聖痕のクェイサー
テレサ＝ベリア	聖痕のクェイサー
天乃翼	聖痕のクェイサー
桂木華	聖痕のクェイサー
御手洗史伽	聖痕のクェイサー
アスタルテ	聖痕のクェイサー
柊弓江	聖痕のクェイサー
桂木萌	臣士魔法劇場_リスキー☆セフティ
セフティ	臣士魔法劇場_リスキー☆セフティ
天河朔夜	舞-HiME
キャトー	花の子ルンルン
タクロー	花の魔法使いマリーベル
レミ	花の魔法使いマリーベル
ジート	花の魔法使いマリーベル
バート	花の魔法使いマリーベル
早苗八島	花右京メイド隊
和倉結名	花咲くいろは
輪島巴	花咲くいろは
四十万スイ	花咲くいろは
松前緒花	花咲くいろは
押水菜子	花咲くいろは
もと子	花咲くいろは
助川電六	花咲くいろは
松前皐月	花咲くいろは
志保	花咲くいろは
富樫蓮二	花咲くいろは
種村孝一	花咲くいろは
貴美	花咲くいろは
鶴来民子	花咲くいろは
次郎丸太郎	花咲くいろは
川尻崇子	花咲くいろは
サイラス	若草物語_ナンとジョー先生
ジョージ・コール	若草物語_ナンとジョー先生
ジョン・ブルック	若草物語_ナンとジョー先生
トシ	英国一家、日本を食べる
マイケル・ブース	英国一家、日本を食べる
塚田	英国一家、日本を食べる
ウィリアム・ジョーンズ	英國戀物語エマ
アデーレ	英國戀物語エマ
グレイス・ジョーンズ	英國戀物語エマ
スティーブンス	英國戀物語エマ
リチャード・ジョーンズ	英國戀物語エマ
アナ・コッポラ	苺ましまろ
桜木茉莉	苺ましまろ
伊藤千佳	苺ましまろ
松岡美羽	苺ましまろ
ラストサムライ	荒川アンダー_ザ_ブリッジ
島崎	荒川アンダー_ザ_ブリッジ
ジャクリーン	荒川アンダー_ザ_ブリッジ
三遊亭圓朝	落語天女おゆい
桂歌丸	落語天女おゆい
三遊亭小遊三	落語天女おゆい
グレスコ	蒼き流星SPTレイズナー
アンナ・ステファニー	蒼き流星SPTレイズナー
デビッド・ラザフォード	蒼き流星SPTレイズナー
ル・カイン	蒼き流星SPTレイズナー
シモーヌ・ルフラン	蒼き流星SPTレイズナー
クレイトン	蒼き流星SPTレイズナー
ジョン・ギルバート	蒼き流星SPTレイズナー
デリンジャー	蒼き流星SPTレイズナー
アルバトロ・ナル・エイジ・アスカ	蒼き流星SPTレイズナー
ロアン・デミトリッヒ	蒼き流星SPTレイズナー
マンジェロ	蒼き流星SPTレイズナー
イ400	蒼き鋼のアルペジオ_-アルス・ノヴァ-
イ402	蒼き鋼のアルペジオ_-アルス・ノヴァ-
八月一日静	蒼き鋼のアルペジオ_-アルス・ノヴァ-
響真瑠璃	蒼き鋼のアルペジオ_-アルス・ノヴァ-
千早群像	蒼き鋼のアルペジオ_-アルス・ノヴァ-
四月一日いおり	蒼き鋼のアルペジオ_-アルス・ノヴァ-
北良寛	蒼き鋼のアルペジオ_-アルス・ノヴァ-
織部僧	蒼き鋼のアルペジオ_-アルス・ノヴァ-
橿原杏平	蒼き鋼のアルペジオ_-アルス・ノヴァ-
千早翔像	蒼き鋼のアルペジオ_-アルス・ノヴァ-
刑部蒔絵	蒼き鋼のアルペジオ_-アルス・ノヴァ-
上陰龍二郎	蒼き鋼のアルペジオ_-アルス・ノヴァ-
一星	蒼天の拳
沈	蒼天の拳
張太炎	蒼天の拳
愛新覚羅溥儀	蒼天の拳
葉子英	蒼天の拳
流飛燕	蒼天の拳
シャルル・ド・ギーズ	蒼天の拳
洪	蒼天の拳
ソフィー	蒼天の拳
芒狂雲	蒼天の拳
普	蒼天の拳
エリカ・アレント	蒼天の拳
霞拳志郎	蒼天の拳
崔	蒼天の拳
劉宗武	蒼天の拳
梨花	蒼天の拳
郭	蒼天の拳
霞羅門	蒼天の拳
遠見真矢	蒼穹のファフナー_RIGHT_OF_LEFT
来主操	蒼穹のファフナー_RIGHT_OF_LEFT
立上芹	蒼穹のファフナー_RIGHT_OF_LEFT
日野美羽	蒼穹のファフナー_RIGHT_OF_LEFT
エメリー・アーモンド	蒼穹のファフナー_RIGHT_OF_LEFT
皆城総士	蒼穹のファフナー_RIGHT_OF_LEFT
ミョルニア	蒼穹のファフナー_RIGHT_OF_LEFT
新見錦	薄桜鬼
天霧九寿	薄桜鬼
島田魁	薄桜鬼
黒田清隆	薄桜鬼
三木三郎	薄桜鬼
井吹龍之介	薄桜鬼
本山小太郎	薄桜鬼
相馬主計	薄桜鬼
君菊	薄桜鬼
山縣有朋	薄桜鬼
佐々木愛次郎	薄桜鬼
野村利三郎	薄桜鬼
松本良順	薄桜鬼
荒井郁之助	薄桜鬼
山崎烝	薄桜鬼
殿内義雄	薄桜鬼
滝川	薄桜鬼
芹沢鴨	薄桜鬼
正木時茂	薄桜鬼
霧島梢	薄桜鬼
千姫	薄桜鬼
松平容保	薄桜鬼
あぐり	薄桜鬼
伊東甲子太郎	薄桜鬼
井上源三郎	薄桜鬼
南雲薫	薄桜鬼
風間千景	薄桜鬼
大鳥圭介	薄桜鬼
家里	薄桜鬼
永倉新八	薄桜鬼
不知火匡	薄桜鬼
雪村綱道	薄桜鬼
平間重助	薄桜鬼
木村恵子	薬師寺涼子の怪奇事件簿
泉田準一郎	薬師寺涼子の怪奇事件簿
薬師寺涼子	薬師寺涼子の怪奇事件簿
丸岡	薬師寺涼子の怪奇事件簿
室町由紀子	薬師寺涼子の怪奇事件簿
桜庭葵	藍より青し〜縁〜
ティナ・フォスター	藍より青し〜縁〜
相澤千鶴	藍より青し〜縁〜
水無月妙子	藍より青し〜縁〜
スティーブン・A・スターフェイズ	血界戦線
ツェッド・オブライエン	血界戦線
ザップ・レンフロ	血界戦線
パトリック	血界戦線
ビビアン	血界戦線
K・K	血界戦線
裸獣汁外衛賤厳	血界戦線
石坂	行け!稲中卓球部
前野	行け!稲中卓球部
北島三郎	行け!稲中卓球部
小暮	行け!稲中卓球部
塩村	行け!稲中卓球部
井沢ひろみ	行け!稲中卓球部
大前田	行け!稲中卓球部
ボギー	行け!稲中卓球部
高井戸	行け!稲中卓球部
菅原	行け!稲中卓球部
加山	行け!稲中卓球部
南田	行け!稲中卓球部
橋本	行け!稲中卓球部
桜井	行け!稲中卓球部
仲田	行け!稲中卓球部
友田	行け!稲中卓球部
沢田	行け!稲中卓球部
耕次郎	行け!稲中卓球部
土井	行け!稲中卓球部
須田	行け!稲中卓球部
一条さゆり	行け!稲中卓球部
星野純子	行け!稲中卓球部
松沢	行け!稲中卓球部
澤崎	行け!稲中卓球部
船橋	行け!稲中卓球部
ちあき	行け!稲中卓球部
岩下京子	行け!稲中卓球部
グレゴルー・ガロッシュ	装甲騎兵ボトムズ
カン・ユー	装甲騎兵ボトムズ
バニラ・バートラー	装甲騎兵ボトムズ
バージル・カースン	装甲騎兵ボトムズ
バイマン・ハガード	装甲騎兵ボトムズ
ワイズマン	装甲騎兵ボトムズ
ジャン・ポール・ロッチナ	装甲騎兵ボトムズ
ブールーズ・ゴウト	装甲騎兵ボトムズ
ル・シャッコ	装甲騎兵ボトムズ
ラダァ・ニーバ	装甲騎兵ボトムズ
インゲ・リーマン	装甲騎兵ボトムズ
ソドム	裏切りは僕の名前を知っている
神命正宗	裏切りは僕の名前を知っている
碓氷愁生	裏切りは僕の名前を知っている
アシュレイ	裏切りは僕の名前を知っている
ルカ＝クロスゼリア	裏切りは僕の名前を知っている
祗王夕月	裏切りは僕の名前を知っている
叢雨九十九	裏切りは僕の名前を知っている
降織千紫郎	裏切りは僕の名前を知っている
バード	西の善き魔女_Astraea_Testament
ハグハグ	覇王大系リューナイト
カッツェ	覇王大系リューナイト
フーコ	見ると強くなる_痛快!横綱アニメ_ああ播磨灘
田中良子	課長王子
レイラ	課長王子
諏訪野亮子	謎の彼女X
波多野	謎の彼女X
西田	謎の彼女X
尾形	謎の彼女X
高宮	謎の彼女X
丘歩子	謎の彼女X
鈴木学	貧乏神が!
箕輪胡桃	貧乏神が!
石蕗梨香	貧乏神が!
伊吹	貧乏神が!
石蕗恵汰	貧乏神が!
艶光路撫子	貧乏神が!
龍胆嵐丸	貧乏神が!
犬神桃央	貧乏神が!
諏訪野菊之進	貧乏神が!
石蕗宙汰	貧乏神が!
桜市子	貧乏神が!
杉原	赤き血のイレブン
町田	赤き血のイレブン
ポピィ	赤ずきんチャチャ
セラヴィー	赤ずきんチャチャ
後藤光	赤ちゃんと僕
真由美	赤ちゃんと僕
正臣	赤ちゃんと僕
榎木実	赤ちゃんと僕
榎木拓也	赤ちゃんと僕
後藤正	赤ちゃんと僕
菊子	赤ちゃんと僕
藤井明美	赤ちゃんと僕
公治	赤ちゃんと僕
大谷	赤ちゃんと僕
幸子	赤ちゃんと僕
白雪	赤髪の白雪姫
山咲美由	超GALS!寿蘭
マジェコンヌ	超次元ゲイム_ネプテューヌ
イストワール	超次元ゲイム_ネプテューヌ
RED	超次元ゲイム_ネプテューヌ
ユニ	超次元ゲイム_ネプテューヌ
ブラン	超次元ゲイム_ネプテューヌ
桐谷.M.キリト	超爆裂異次元メンコバトル_ギガントシューター_つかさ
クリスティーン	超爆裂異次元メンコバトル_ギガントシューター_つかさ
小出ミル子	超爆裂異次元メンコバトル_ギガントシューター_つかさ
沼田マナブ	超爆裂異次元メンコバトル_ギガントシューター_つかさ
カシス	超発明BOYカニパン
月里光	超速変形ジャイロゼッター
向井晶	超速変形ジャイロゼッター
大柄リカコ	超速変形ジャイロゼッター
宇田川大地	超速変形ジャイロゼッター
轟奈々子	超速変形ジャイロゼッター
久石豊	超速変形ジャイロゼッター
七津星	超速変形ジャイロゼッター
桐生息吹	超速変形ジャイロゼッター
速水俊介	超速変形ジャイロゼッター
ゴート	超速変形ジャイロゼッター
稲葉りんね	超速変形ジャイロゼッター
マイクマン関	超速変形ジャイロゼッター
矢野烈火	超速変形ジャイロゼッター
鈴川かえで	超速変形ジャイロゼッター
ハルカ	超速変形ジャイロゼッター
軍司壮太	超速変形ジャイロゼッター
赤名累	超速変形ジャイロゼッター
久堂エリカ	超速変形ジャイロゼッター
トーイ	超魔神英雄伝ワタル
炎部ワタル	超魔神英雄伝ワタル
トップスピン	超魔神英雄伝ワタル
サンダール	超魔神英雄伝ワタル
田所正蔵	輪廻のラグランジェ
中泉ようこ	輪廻のラグランジェ
上原はるか	輪廻のラグランジェ
フィン・エ・ルド・スイ・ラフィンティ	輪廻のラグランジェ
芹沢颯太	輪廻のラグランジェ
岩淵まちこ	輪廻のラグランジェ
ムギナミ	輪廻のラグランジェ
バランス・T・モイド	輪廻のラグランジェ
デ・メトリオ・ル・ユリカノ	輪廻のラグランジェ
フィン・エ・ルド・シ・ディセルマイン	輪廻のラグランジェ
アステリア・リーザマリー・ド・ロシュフォール	輪廻のラグランジェ
ちづる	迷い猫オーバーラン!
はづき	迷い猫オーバーラン!
佐藤一美	迷い猫オーバーラン!
鈴木裕子	迷い猫オーバーラン!
早乙女博士	迷い猫オーバーラン!
都築乙女	迷い猫オーバーラン!
十和野心	迷い猫オーバーラン!
霧谷希	迷い猫オーバーラン!
余市健彦	這いよれ!_ニャル子さん
クー音	這いよれ!_ニャル子さん
クラーク・アシュトン・スミス	這いよれ!_ニャル子さん
暮井珠緒	這いよれ!_ニャル子さん
ハス太	這いよれ!_ニャル子さん
ニャル夫	這いよれ!_ニャル子さん
ツル子	這いよれ!_ニャル子さん
八坂頼子	這いよれ!_ニャル子さん
銀アト子	這いよれ!_ニャル子さん
ルーヒー・ジストーン	這いよれ!_ニャル子さん
八坂真尋	這いよれ!_ニャル子さん
ニャル恵	這いよれ!_ニャル子さん
グタタン	這いよれ!_ニャル子さん
ニャル子	這いよれ!_ニャル子さん
オルオ・ボザド	進撃の巨人
エルヴィン・スミス	進撃の巨人
ミケ・ザカリアス	進撃の巨人
ナイル・ドーク	進撃の巨人
イザベル・マグノリア	進撃の巨人
ライナー・ブラウン	進撃の巨人
フリーダ・レイス	進撃の巨人
グリシャ・イェーガー	進撃の巨人
エルド・ジン	進撃の巨人
アニ・レオンハート	進撃の巨人
サシャ・ブラウス	進撃の巨人
ナナバ	進撃の巨人
ハンネス	進撃の巨人
ミーナ・カロライナ	進撃の巨人
イルゼ・ラングナー	進撃の巨人
モブリット・バーナー	進撃の巨人
グンタ・シュルツ	進撃の巨人
ベルトルト・フーバー	進撃の巨人
ドット・ピクシス	進撃の巨人
マルロ・フロイデンベルク	進撃の巨人
ペトラ・ラル	進撃の巨人
トーマス・ワグナー	進撃の巨人
ダズ	進撃の巨人
カルラ・イェーガー	進撃の巨人
ファーラン・チャーチ	進撃の巨人
ニック司祭	進撃の巨人
ヒッチ・ドリス	進撃の巨人
ユミル	進撃の巨人
ジャン・キルシュタイン	進撃の巨人
方中ミエル	遊☆戯☆王ARC-V
茂古田未知夫	遊☆戯☆王ARC-V
バレット	遊☆戯☆王ARC-V
黒咲瑠璃	遊☆戯☆王ARC-V
権現坂昇	遊☆戯☆王ARC-V
神月アレン	遊☆戯☆王ARC-V
ジャン・ミシェル・ロジェ	遊☆戯☆王ARC-V
沢渡シンゴ	遊☆戯☆王ARC-V
志島北斗	遊☆戯☆王ARC-V
徳松長次郎	遊☆戯☆王ARC-V
笹山サヤカ	遊☆戯☆王ARC-V
赤馬零児	遊☆戯☆王ARC-V
炎城ムクロ	遊☆戯☆王ARC-V
セルゲイ・ヴォルコフ	遊☆戯☆王ARC-V
勝鬨勇雄	遊☆戯☆王ARC-V
ギャラガー	遊☆戯☆王ARC-V
タイラー姉妹	遊☆戯☆王ARC-V
九庵堂栄太	遊☆戯☆王ARC-V
光津真澄	遊☆戯☆王ARC-V
デュエルチェイサー227	遊☆戯☆王ARC-V
黒咲隼	遊☆戯☆王ARC-V
柊柚子	遊☆戯☆王ARC-V
イェーガー	遊☆戯☆王ARC-V
榊洋子	遊☆戯☆王ARC-V
赤馬日美香	遊☆戯☆王ARC-V
鮎川アユ	遊☆戯☆王ARC-V
榊遊勝	遊☆戯☆王ARC-V
紫雲院素良	遊☆戯☆王ARC-V
メリッサ・クレール	遊☆戯☆王ARC-V
刀堂刃	遊☆戯☆王ARC-V
天城ハルト	遊☆戯☆王ZEXAL
速見秀太	遊☆戯☆王ZEXAL
オービタル7	遊☆戯☆王ZEXAL
チャーリー・マッコイ	遊☆戯☆王ZEXAL
エリファス	遊☆戯☆王ZEXAL
神月アンナ	遊☆戯☆王ZEXAL
ギラグ	遊☆戯☆王ZEXAL
ベクター	遊☆戯☆王ZEXAL
ドン・サウザンド	遊☆戯☆王ZEXAL
ドロワ	遊☆戯☆王ZEXAL
メラグ	遊☆戯☆王ZEXAL
九十九春	遊☆戯☆王ZEXAL
ミザエル	遊☆戯☆王ZEXAL
Mr.ハートランド	遊☆戯☆王ZEXAL
蝉丸	遊☆戯☆王ZEXAL
クラゲ先輩	遊☆戯☆王ZEXAL
キャッシー	遊☆戯☆王ZEXAL
北野右京	遊☆戯☆王ZEXAL
Dr.フェイカー	遊☆戯☆王ZEXAL
ドルベ	遊☆戯☆王ZEXAL
ゴーシュ	遊☆戯☆王ZEXAL
バイロン・アークライト	遊☆戯☆王ZEXAL
片桐大介	遊☆戯☆王ZEXAL
ジンロン	遊☆戯☆王ZEXAL
アクナディン	遊☆戯☆王デュエルモンスターズ
盗賊王バクラ	遊☆戯☆王デュエルモンスターズ
リシド	遊☆戯☆王デュエルモンスターズ
マナ	遊☆戯☆王デュエルモンスターズ
牛尾	遊☆戯☆王デュエルモンスターズ
磯野	遊☆戯☆王デュエルモンスターズ
シンディア	遊☆戯☆王デュエルモンスターズ
猿渡	遊☆戯☆王デュエルモンスターズ
海馬瀬人	遊☆戯☆王デュエルモンスターズ
アーサー・ホプキンス	遊☆戯☆王デュエルモンスターズ
ダイナソー竜崎	遊☆戯☆王デュエルモンスターズ
アクナムカノン	遊☆戯☆王デュエルモンスターズ
城之内克也	遊☆戯☆王デュエルモンスターズ
武藤双六	遊☆戯☆王デュエルモンスターズ
シャーディー	遊☆戯☆王デュエルモンスターズ
川井静香	遊☆戯☆王デュエルモンスターズ
マハード	遊☆戯☆王デュエルモンスターズ
獏良了	遊☆戯☆王デュエルモンスターズ
蝶野	遊☆戯☆王デュエルモンスターズ
エスパー絽場	遊☆戯☆王デュエルモンスターズ
アテム	遊☆戯☆王デュエルモンスターズ
御伽龍児	遊☆戯☆王デュエルモンスターズ
アイシス	遊☆戯☆王デュエルモンスターズ
Mr.クロケッツ	遊☆戯☆王デュエルモンスターズ
イシズ・イシュタール	遊☆戯☆王デュエルモンスターズ
井守はじめ	遊☆戯☆王デュエルモンスターズ
パイク	遊星仮面
リコ	遊星少年パピイ
源九郎義経	遙かなる時空の中で3
平清盛	遙かなる時空の中で3
平知盛	遙かなる時空の中で3
藤原秀衡	遙かなる時空の中で3
平惟盛	遙かなる時空の中で3
梶原朔	遙かなる時空の中で3
北条政子	遙かなる時空の中で3
有川将臣	遙かなる時空の中で3
有川譲	遙かなる時空の中で3
平敦盛	遙かなる時空の中で3
平経正	遙かなる時空の中で3
安徳天皇	遙かなる時空の中で3
梶原景時	遙かなる時空の中で3
春日望美	遙かなる時空の中で3
平忠度	遙かなる時空の中で3
クワサン・オリビー	重戦機エルガイム
フル・フラット	重戦機エルガイム
オルドナ・ポセイダル	重戦機エルガイム
ネイ・モー・ハン	重戦機エルガイム
リリス・ファウ	重戦機エルガイム
ニコマコス	重戦機エルガイム
ミラウー・キャオ	重戦機エルガイム
ガウ・ハ・レッシイ	重戦機エルガイム
村上草太	金田一少年の事件簿
正野	金田一少年の事件簿
千家貴司	金田一少年の事件簿
パトリシア・オブライエン	金田一少年の事件簿
桜樹るい子	金田一少年の事件簿
金田一二三	金田一少年の事件簿
ポアロ	金田一少年の事件簿
月読ジゼル	金田一少年の事件簿
速水玲香	金田一少年の事件簿
天宮静	金色のコルダ_Blue♪Sky
冥加玲士	金色のコルダ_Blue♪Sky
八木沢雪広	金色のコルダ_Blue♪Sky
水嶋悠人	金色のコルダ_Blue♪Sky
如月律	金色のコルダ_Blue♪Sky
七海宗介	金色のコルダ_Blue♪Sky
如月響也	金色のコルダ_Blue♪Sky
芹沢睦	金色のコルダ_Blue♪Sky
氷渡貴史	金色のコルダ_Blue♪Sky
水嶋新	金色のコルダ_Blue♪Sky
火積司郎	金色のコルダ_Blue♪Sky
東金千秋	金色のコルダ_Blue♪Sky
火原和樹	金色のコルダ_Blue♪Sky
遠藤イズナ	鉄のラインバレル
加藤久嵩	鉄のラインバレル
ジュディ・ブラウン	鉄のラインバレル
ユリアンヌ・フェイスフル	鉄のラインバレル
森次玲二	鉄のラインバレル
道明寺誠	鉄のラインバレル
新山理沙子	鉄のラインバレル
レイチェル・キャルヴィン	鉄のラインバレル
桐山英治	鉄のラインバレル
緒川結衣	鉄のラインバレル
山下サトル	鉄のラインバレル
石神邦生	鉄のラインバレル
城崎絵美	鉄のラインバレル
ジャック・スミス	鉄のラインバレル
王政陸	鉄のラインバレル
菅原マサキ	鉄のラインバレル
矢島英明	鉄のラインバレル
轟剛	銀の匙_Silver_Spoon
別府太郎	銀の匙_Silver_Spoon
近藤豊	銀の匙_Silver_Spoon
南九条あやめ	銀の匙_Silver_Spoon
広野	銀の匙_Silver_Spoon
八軒慎吾	銀の匙_Silver_Spoon
稲田真一郎	銀の匙_Silver_Spoon
西川一	銀の匙_Silver_Spoon
中島美雪	銀の匙_Silver_Spoon
依田勉	銀の匙_Silver_Spoon
御影アキ	銀の匙_Silver_Spoon
吉野まゆみ	銀の匙_Silver_Spoon
中矢	銀の匙_Silver_Spoon
富士一子	銀の匙_Silver_Spoon
相川進之介	銀の匙_Silver_Spoon
駒場一郎	銀の匙_Silver_Spoon
西園寺玲華	銀河へキックオフ!!
杉山多義	銀河へキックオフ!!
降矢竜持	銀河へキックオフ!!
高遠エリカ	銀河へキックオフ!!
出川	銀河へキックオフ!!
太田紗	銀河へキックオフ!!
降矢凰壮	銀河へキックオフ!!
花島勝	銀河へキックオフ!!
景浦晶	銀河へキックオフ!!
須黒	銀河へキックオフ!!
青砥ゴンザレス琢馬	銀河へキックオフ!!
内村桂	銀河へキックオフ!!
降矢虎太	銀河へキックオフ!!
郷田	銀河へキックオフ!!
植松太郎	銀河へキックオフ!!
田中純	銀河へキックオフ!!
太田健	銀河へキックオフ!!
骸山	銀河戦国群雄伝ライ
麗羅	銀河戦国群雄伝ライ
鳳鳴	銀河戦国群雄伝ライ
狼刃	銀河戦国群雄伝ライ
カーメン・カーメン	銀河旋風ブライガー
メイ・リン・ホー	銀河旋風ブライガー
クギミヤ・ケイ	銀河機攻隊_マジェスティックプリンス
ナトリ・シオン	銀河機攻隊_マジェスティックプリンス
アマネ・ハヅキ	銀河機攻隊_マジェスティックプリンス
ジュリアーノ・ヴィスコンティ	銀河機攻隊_マジェスティックプリンス
ランディ・マクスウエル	銀河機攻隊_マジェスティックプリンス
アサギ・トシカズ	銀河機攻隊_マジェスティックプリンス
パトリック・ホイル	銀河機攻隊_マジェスティックプリンス
ルティエル	銀河機攻隊_マジェスティックプリンス
山田ペコ	銀河機攻隊_マジェスティックプリンス
ラダ	銀河機攻隊_マジェスティックプリンス
ディエゴ	銀河機攻隊_マジェスティックプリンス
ヒタチ・イズル	銀河機攻隊_マジェスティックプリンス
マテオ	銀河機攻隊_マジェスティックプリンス
西園寺レイカ	銀河機攻隊_マジェスティックプリンス
ルーラ・チャン	銀河機攻隊_マジェスティックプリンス
ルメス	銀河機攻隊_マジェスティックプリンス
ジアート	銀河機攻隊_マジェスティックプリンス
テオーリア	銀河機攻隊_マジェスティックプリンス
ラケシュ・チャンドラセカール	銀河機攻隊_マジェスティックプリンス
シモン・ガトゥ	銀河機攻隊_マジェスティックプリンス
クロキ・アンジュ	銀河機攻隊_マジェスティックプリンス
ダニール	銀河機攻隊_マジェスティックプリンス
スルガ・アタル	銀河機攻隊_マジェスティックプリンス
クレイン	銀河機攻隊_マジェスティックプリンス
ジークフリート・フォン・ヴェスターナッハ	銀河機攻隊_マジェスティックプリンス
イリエ・タマキ	銀河機攻隊_マジェスティックプリンス
ガルキエ	銀河機攻隊_マジェスティックプリンス
ケンツ・ノートン	銀河漂流バイファム
ケイト・ハザウェイ	銀河漂流バイファム
バーツ・ライアン	銀河漂流バイファム
マルロ・Jr.・ボナー	銀河漂流バイファム
シュトロハイム	銀河漂流バイファム
ジミー・エリル	銀河漂流バイファム
シャロン・パブリン	銀河漂流バイファム
ペンチ・イライザ	銀河漂流バイファム
フレッド・シャッフル	銀河漂流バイファム
クレア・バーブランド	銀河漂流バイファム
マキ・ローウェル	銀河漂流バイファム
スコット・ヘイワード	銀河漂流バイファム
サイトー	銀河烈風バクシンガー
ジャッキー・リー	銀河烈風バクシンガー
ドン・コンドール	銀河烈風バクシンガー
プロメシューム	銀河鉄道999
機械伯爵	銀河鉄道999
イワノフ・レオニドヴィチ・ベリチュコフ	銀河鉄道物語
星野鉄郎	銀河鉄道物語
村瀬	銀河鉄道物語
オーウェン	銀河鉄道物語
有紀渉	銀河鉄道物語_〜永遠への分岐点〜
シュワンヘルト・バルジ	銀河鉄道物語_〜永遠への分岐点〜
デイビッド・ヤング	銀河鉄道物語_〜永遠への分岐点〜
秀俊	銀牙_-流れ星_銀-
陣内	銀牙_-流れ星_銀-
信男	銀牙_-流れ星_銀-
紅桜	銀牙_-流れ星_銀-
ドーベルマン	銀牙伝説WEED
サルーキー	銀牙伝説WEED
レフティ	銀牙伝説WEED
テル	銀牙伝説WEED
ドミニク・ミラー	銀盤カレイドスコープ
ドミニク	銀色のオリンシス
ミスズ	銀色のオリンシス
テア	銀色のオリンシス
トーマス	銀色のオリンシス
メイ・リー	銀装騎攻オーディアン
並木準也	銀装騎攻オーディアン
来島また子	銀魂
浦島	銀魂
ハイジ	銀魂
しんちゃん	銀魂
池沢	銀魂
志村妙	銀魂
西野掴	銀魂
葛葉	銀魂
バブルス王女	銀魂
松尾	銀魂
金丸	銀魂
村田鉄子	銀魂
松平栗子	銀魂
佐々木鉄之助	銀魂
河上万斉	銀魂
篠原進之進	銀魂
道信	銀魂
十郎太	銀魂
坂本辰馬	銀魂
伊東鴨太郎	銀魂
GOEMON	銀魂
中村京次郎	銀魂
神山	銀魂
剛	銀魂
加藤健	銀魂
佐々木異三郎	銀魂
吉田松陽	銀魂
フミ子	銀魂
寺門通	銀魂
よっちゃん	銀魂
お奉行	銀魂
原田右之助	銀魂
百音	銀魂
海老名	銀魂
友之助	銀魂
中崎	銀魂
時子	銀魂
怪盗キャッツイアー	銀魂
定春	銀魂
平蔵	銀魂
斉藤終	銀魂
長谷川泰三	銀魂
近藤勲	銀魂
隈無清蔵	銀魂
南戸粋	銀魂
今井信女	銀魂
KIYOSHI	銀魂
井上	銀魂
勇二	銀魂
武市変平太	銀魂
池田朝右衛門	銀魂
北大路大五郎	銀魂
下元	銀魂
阿伏兎	銀魂
池田夜右衛門	銀魂
長谷川ハツ	銀魂
東城歩	銀魂
服部全蔵	銀魂
米堕卿	銀魂
七兵衛	銀魂
亀梨	銀魂
小銭形平次	銀魂
桂小太郎	銀魂
お登勢	銀魂
茂吉	銀魂
アンドロメダ	銀魂
尾美一	銀魂
岩松	銀魂
外道丸	銀魂
太助	銀魂
松太郎	銀魂
八郎	銀魂
猿飛あやめ	銀魂
小東	銀魂
永井	銀魂
越後屋	銀魂
空知英秋	銀魂
おりょう	銀魂
章二	銀魂
土方十四郎	銀魂
北大路斎	銀魂
山崎退	銀魂
サチ子	銀魂
猛	銀魂
徳川定々	銀魂
マダム夜神	銀魂
稲山	銀魂
野島	銀魂
ペドロ	銀魂
柳生輿矩	銀魂
柳生敏木斎	銀魂
根津	銀魂
ハタ皇子	銀魂
大藤	銀魂
鳥羽	銀魂
梨本	銀魂
地雷亜	銀魂
吉沢	銀魂
物部悠	銃皇無尽のファフニール
ディラン	銃皇無尽のファフニール
シャーニッド・エリプトン	鋼殻のレギオス
レイフォン・アルセイフ	鋼殻のレギオス
卯月美和	鋼鉄ジーグ
ミハエル	鋼鉄天使くるみ
皇うるか	鋼鉄天使くるみ
加賀	鋼鉄天使くるみ
カオリ	鋼鉄天使くるみ
司馬宙	鋼鉄神ジーグ
妃魅禍	鋼鉄神ジーグ
司馬遷次郎	鋼鉄神ジーグ
美角鏡	鋼鉄神ジーグ
桐原きらは	鍵姫物語_永久アリス輪舞曲
那唖挫	鎧伝サムライトルーパー
迦遊羅	鎧伝サムライトルーパー
悪奴弥守	鎧伝サムライトルーパー
山野純	鎧伝サムライトルーパー
柳生三厳	鎧伝サムライトルーパー
ナスティ柳生	鎧伝サムライトルーパー
朱天童子	鎧伝サムライトルーパー
朝比奈みくる	長門有希ちゃんの消失
朝倉涼子	長門有希ちゃんの消失
キョンの妹	長門有希ちゃんの消失
谷口	長門有希ちゃんの消失
古泉一樹	長門有希ちゃんの消失
キョン	長門有希ちゃんの消失
鶴屋さん	長門有希ちゃんの消失
森園生	長門有希ちゃんの消失
涼宮ハルヒ	長門有希ちゃんの消失
柳生	閃乱カグラ
鈴音	閃乱カグラ
道元	閃乱カグラ
森島守人	閃光のナイトレイド
市ノ瀬	閃光のナイトレイド
林久治郎	閃光のナイトレイド
花谷正	閃光のナイトレイド
ヴィクター・ブルワー＝リットン	閃光のナイトレイド
頭山満	閃光のナイトレイド
マリア・ウォン	闇の末裔
邑輝一貴	闇の末裔
巽征一郎	闇の末裔
亘理温	闇の末裔
壬生織也	闇の末裔
閂若葉	闇の末裔
黒崎密	闇の末裔
雲隠ホタル	陰からマモル!
紺若ゆうな	陰からマモル!
服部山芽	陰からマモル!
真双津椿	陰からマモル!
沢菓愛里	陰からマモル!
楓のクレナイ	陰陽大戦記
甘露のミユキ	陰陽大戦記
青龍のキバチヨ	陰陽大戦記
トモミ	陰陽大戦記
イッセイ	陰陽大戦記
ダイカン	陰陽大戦記
キリヒト	陰陽大戦記
玄武のコロク	陰陽大戦記
飛鳥ユーマ	陰陽大戦記
西郷テル	陰陽大戦記
丸山シルヴィア	陸上防衛隊まおちゃん
はな	隆一まんが劇場_おんぶおばけ
さゆり	隆一まんが劇場_おんぶおばけ
ゴン	隆一まんが劇場_おんぶおばけ
きぬ	隆一まんが劇場_おんぶおばけ
佐吉	隆一まんが劇場_おんぶおばけ
留吉	隆一まんが劇場_おんぶおばけ
清水雷鳴	隠の王
雲平・帷・デュランダル	隠の王
南十字	隠の王
雪見和彦	隠の王
清水雷光	隠の王
目黒俄雨	隠の王
相澤虹一	隠の王
宵風	隠の王
星宮社	電波女と青春男
花沢さん	電波女と青春男
小牧	電波女と青春男
御船流子	電波女と青春男
大井藍	電波女と青春男
鑑純一郎	電波教師
叶美奈子	電波教師
鑑純音	電波教師
荒木光太郎	電波教師
桃園マキナ	電波教師
蔵持円	電波教師
バズ	青いブリンク
丹波	青いブリンク
ブリンク	青いブリンク
アフロ	青いブリンク
ルンパッパ	青いブリンク
スピカ	青いブリンク
勝呂達磨	青の祓魔師
奥村燐	青の祓魔師
朴朔子	青の祓魔師
志摩廉造	青の祓魔師
奥村雪男	青の祓魔師
霧隠シュラ	青の祓魔師
勝呂竜士	青の祓魔師
ユリ・エギン	青の祓魔師
神木出雲	青の祓魔師
宝ねむ	青の祓魔師
杜山しえみ	青の祓魔師
志摩金造	青の祓魔師
志摩柔造	青の祓魔師
藤本獅郎	青の祓魔師
佐藤慎一	青の祓魔師
三輪子猫丸	青の祓魔師
藤本高虎	青春×機関銃
緑永将	青春×機関銃
赤羽市	青春×機関銃
雪村透	青春×機関銃
松岡正宗	青春×機関銃
立花蛍	青春×機関銃
時縞ソウイチ	革命機ヴァルヴレイヴ
連坊小路サトミ	革命機ヴァルヴレイヴ
連坊小路アキラ	革命機ヴァルヴレイヴ
流木野サキ	革命機ヴァルヴレイヴ
七海リオン	革命機ヴァルヴレイヴ
マニンガー	革命機ヴァルヴレイヴ
指南ショーコ	革命機ヴァルヴレイヴ
エルエルフ	革命機ヴァルヴレイヴ
貴生川タクミ	革命機ヴァルヴレイヴ
北川イオリ	革命機ヴァルヴレイヴ
野火マリエ	革命機ヴァルヴレイヴ
時縞ハルト	革命機ヴァルヴレイヴ
クリムヒルト	革命機ヴァルヴレイヴ
イクスアイン	革命機ヴァルヴレイヴ
カイン・ドレッセル	革命機ヴァルヴレイヴ
山田ライゾウ	革命機ヴァルヴレイヴ
クーフィア	革命機ヴァルヴレイヴ
櫻井アイナ	革命機ヴァルヴレイヴ
リーゼロッテ・W・ドルシア	革命機ヴァルヴレイヴ
ハーノイン	革命機ヴァルヴレイヴ
犬塚キューマ	革命機ヴァルヴレイヴ
アマデウス・K・ドルシア	革命機ヴァルヴレイヴ
二宮タカヒ	革命機ヴァルヴレイヴ
アードライ	革命機ヴァルヴレイヴ
霊屋ユウスケ	革命機ヴァルヴレイヴ
デリウス・バーテンベルク	革命機ヴァルヴレイヴ
鮫島牙舞	韋駄天翔
鮫島大牙	韋駄天翔
獅堂まこと	韋駄天翔
後藤卓也	響け!_ユーフォニアム
長瀬梨子	響け!_ユーフォニアム
黄前麻美子	響け!_ユーフォニアム
田中あすか	響け!_ユーフォニアム
中川夏紀	響け!_ユーフォニアム
小笠原晴香	響け!_ユーフォニアム
斎藤葵	響け!_ユーフォニアム
吉川優子	響け!_ユーフォニアム
中世古香織	響け!_ユーフォニアム
塚本秀一	響け!_ユーフォニアム
加藤葉月	響け!_ユーフォニアム
川島緑輝	響け!_ユーフォニアム
岩瀬恭子	頭文字D
横田	頭文字D
佐竹	頭文字D
会川	頭文字D
奈保	頭文字D
沙雪	頭文字D
正一	頭文字D
小柏カイ	頭文字D
野上	頭文字D
宮口	頭文字D
秋山渉	頭文字D
健二	頭文字D
佐藤真子	頭文字D
東堂	頭文字D
史浩	頭文字D
二宮大輝	頭文字D
武内樹	頭文字D
慎一	頭文字D
土屋	頭文字D
滋	頭文字D
久保英次	頭文字D
宮原	頭文字D
藤原文太	頭文字D
舘智幸	頭文字D
章央	頭文字D
マリアン	風の中の少女_金髪のジェニー
サンディ	風の中の少女_金髪のジェニー
ハーマン	風の中の少女_金髪のジェニー
ビッグ・ジョー	風の中の少女_金髪のジェニー
アンジェラ	風の中の少女_金髪のジェニー
ヒラリー	風の中の少女_金髪のジェニー
ハロルド	風の中の少女_金髪のジェニー
ポーラ	風の中の少女_金髪のジェニー
ジョンソン	風の中の少女_金髪のジェニー
コニー	風の中の少女_金髪のジェニー
涼子	風人物語
好三郎	風人物語
服部霧子	風雲維新ダイ☆ショーグン
つばき	風雲維新ダイ☆ショーグン
ちはる	風雲維新ダイ☆ショーグン
桜木	風雲維新ダイ☆ショーグン
井伊	風雲維新ダイ☆ショーグン
龍二	風雲維新ダイ☆ショーグン
松平	風雲維新ダイ☆ショーグン
浅井兵庫	風雲維新ダイ☆ショーグン
法光院	風雲維新ダイ☆ショーグン
汐見潤	食戟のソーマ
美作昴	食戟のソーマ
田所恵	食戟のソーマ
水戸郁魅	食戟のソーマ
堂島銀	食戟のソーマ
イサミ・アルディーニ	食戟のソーマ
榊涼子	食戟のソーマ
葉山アキラ	食戟のソーマ
幸平城一郎	食戟のソーマ
大御堂ふみ緒	食戟のソーマ
黒木場リョウ	食戟のソーマ
薙切仙左衛門	食戟のソーマ
タクミ・アルディーニ	食戟のソーマ
北条美代子	食戟のソーマ
丸井善二	食戟のソーマ
伊武崎峻	食戟のソーマ
薙切アリス	食戟のソーマ
乾日向子	食戟のソーマ
川島麗	食戟のソーマ
幸平創真	食戟のソーマ
貞塚ナオ	食戟のソーマ
吉野悠姫	食戟のソーマ
一色慧	食戟のソーマ
峰ヶ崎八重子	食戟のソーマ
倉瀬真由美	食戟のソーマ
新戸緋沙子	食戟のソーマ
叡山枝津也	食戟のソーマ
小西寛一	食戟のソーマ
四宮小次郎	食戟のソーマ
薙切えりな	食戟のソーマ
柿助	鬼灯の冷徹
レディ・リリス	鬼灯の冷徹
小野篁	鬼灯の冷徹
源義経	鬼灯の冷徹
五道転輪王	鬼灯の冷徹
白澤	鬼灯の冷徹
スケープ	鬼灯の冷徹
夜叉一	鬼灯の冷徹
ルリオ	鬼灯の冷徹
亜子	鬼神童子ZENKI
役小明	鬼神童子ZENKI
桑折	鬼神童子ZENKI
栗林	鬼神童子ZENKI
役小角	鬼神童子ZENKI
山口ノボル	魁!!クロマティ高校
中尾明	魁!!クロマティ高校
貞治	魁!!クロマティ高校
山本一郎	魁!!クロマティ高校
石川淳	魁!!クロマティ高校
島野	魁!!クロマティ高校
宇宙人	魁!!クロマティ高校
北斗の子分	魁!!クロマティ高校
神山高志	魁!!クロマティ高校
前田彰	魁!!クロマティ高校
北斗武士	魁!!クロマティ高校
マサ	魁!!クロマティ高校
フレディ	魁!!クロマティ高校
ブライアン・ジョーンズ	魁!!男塾
笹川	魍魎の匣
中禅寺秋彦	魍魎の匣
中禅寺千鶴子	魍魎の匣
関口巽	魍魎の匣
久保竣公	魍魎の匣
鳥口守彦	魍魎の匣
清野	魍魎の匣
安和寅吉	魍魎の匣
木場修太郎	魍魎の匣
青木文蔵	魍魎の匣
中禅寺敦子	魍魎の匣
三重鳩宗	魔乳秘剣帖
魔乳胸幸	魔乳秘剣帖
魔乳影房	魔乳秘剣帖
魔乳千房	魔乳秘剣帖
絵石家由香	魔人探偵脳噛ネウロ
トガシ	魔人探偵脳噛ネウロ
本城刹那	魔人探偵脳噛ネウロ
春川英輔	魔人探偵脳噛ネウロ
笛吹直大	魔人探偵脳噛ネウロ
笹塚衛士	魔人探偵脳噛ネウロ
石垣筍	魔人探偵脳噛ネウロ
早乙女國春	魔人探偵脳噛ネウロ
筑紫候平	魔人探偵脳噛ネウロ
吾代忍	魔人探偵脳噛ネウロ
ステファン	魔動王グランゾート
黒武者	魔動王グランゾート
オセロ	魔動王グランゾート
ニジンスキー・スカラバカヤ	魔動王グランゾート
ノーア	魔動王グランゾート
スノーウィー	魔動王グランゾート
ポノ	魔動王グランゾート
蘭堂ミキ	魔境伝説アクロバンチ
蘭堂ヒロ	魔境伝説アクロバンチ
タケシ	魔女っ子チックル
勉	魔女っ子チックル
重雄	魔女っ子チックル
圭子	魔女っ子チックル
錦三郎	魔女っ子チックル
小太郎	魔女っ子チックル
明	魔女っ子チックル
サターン	魔女っ子メグちゃん
エミ	魔女っ子メグちゃん
神崎	魔女っ子メグちゃん
パトラ	魔女っ子メグちゃん
ロラン	魔弾の王と戦姫
リムアリーシャ	魔弾の王と戦姫
ティッタ	魔弾の王と戦姫
オーギュスト	魔弾の王と戦姫
エミール	魔弾の王と戦姫
フレイヤ	魔探偵ロキRAGNAROK
闇野竜介	魔探偵ロキRAGNAROK
大堂寺繭良	魔探偵ロキRAGNAROK
大島玲也	魔探偵ロキRAGNAROK
フレイ	魔探偵ロキRAGNAROK
高木	魔法つかいプリキュア!
結希かの子	魔法つかいプリキュア!
朝日奈大吉	魔法つかいプリキュア!
大野壮太	魔法つかいプリキュア!
魔法の水晶	魔法つかいプリキュア!
長瀬まゆみ	魔法つかいプリキュア!
勝木かな	魔法つかいプリキュア!
モフルン	魔法つかいプリキュア!
ロレッタ	魔法つかいプリキュア!
トポ	魔法のスターマジカルエミ
今市	魔法のステージファンシーララ
吉田太郎	魔法のステージファンシーララ
星沢	魔法のステージファンシーララ
ヨシオ	魔法のステージファンシーララ
室井力	魔法の妖精ペルシャ
メソメソ	魔法の妖精ペルシャ
シンバ	魔法の妖精ペルシャ
愛川茜	魔法使いTai!
中富七香	魔法使いTai!
鳴滝風香	魔法先生ネギま!
タカミチ・T・高畑	魔法先生ネギま!
エヴァンジェリン・A・K・マクダウェル	魔法先生ネギま!
宮崎のどか	魔法先生ネギま!
ナギ・スプリングフィールド	魔法先生ネギま!
英子	魔法先生ネギま!
柿崎美砂	魔法先生ネギま!
ジャック・ラカン	魔法先生ネギま!
フェイト・アーウェルンクス	魔法先生ネギま!
長瀬楓	魔法先生ネギま!
那波千鶴	魔法先生ネギま!
相坂さよ	魔法先生ネギま!
村上夏美	魔法先生ネギま!
ネギ・スプリングフィールド	魔法先生ネギま!
和泉亜子	魔法先生ネギま!
高音・D・グッドマン	魔法先生ネギま!
近衛木乃香	魔法先生ネギま!
四葉五月	魔法先生ネギま!
月詠	魔法先生ネギま!
釘宮円	魔法先生ネギま!
鳴滝史伽	魔法先生ネギま!
朝倉和美	魔法先生ネギま!
チャチャゼロ	魔法先生ネギま!
椎名桜子	魔法先生ネギま!
ケムリ	魔法少女大戦
フウリン	魔法少女大戦
ナツミ	魔法少女大戦
MANA	魔法少女大戦
ちとせ	魔法少女猫たると
トルテ	魔法少女猫たると
たると	魔法少女猫たると
四条桃花	魔法戦争
伊田一三	魔法戦争
相羽六	魔法戦争
七瀬月光	魔法戦争
相羽十	魔法戦争
鷲津吉平	魔法戦争
リジャール	魔法戦士リウイ
ミレル	魔法戦士リウイ
アイラ	魔法戦士リウイ
ジェニ	魔法戦士リウイ
セレシア	魔法戦士リウイ
カーウェス	魔法戦士リウイ
ダーダネル	魔法戦士リウイ
ジーニ	魔法戦士リウイ
小野遥	魔法科高校の劣等生
森崎駿	魔法科高校の劣等生
五十里啓	魔法科高校の劣等生
壬生紗耶香	魔法科高校の劣等生
里美スバル	魔法科高校の劣等生
廿楽計夫	魔法科高校の劣等生
黒羽文弥	魔法科高校の劣等生
司波小百合	魔法科高校の劣等生
桐原武明	魔法科高校の劣等生
西城レオンハルト	魔法科高校の劣等生
吉田幹比古	魔法科高校の劣等生
吉祥寺真紅郎	魔法科高校の劣等生
九重八雲	魔法科高校の劣等生
柳連	魔法科高校の劣等生
北山雫	魔法科高校の劣等生
司波達也	魔法科高校の劣等生
光井ほのか	魔法科高校の劣等生
服部刑部少丞範蔵	魔法科高校の劣等生
アンジェリーナ＝クドウ＝シールズ	魔法科高校の劣等生
四葉真夜	魔法科高校の劣等生
黒羽亜夜子	魔法科高校の劣等生
千代田花音	魔法科高校の劣等生
藤林響子	魔法科高校の劣等生
柴田美月	魔法科高校の劣等生
司波龍郎	魔法科高校の劣等生
渡辺摩利	魔法科高校の劣等生
千葉修次	魔法科高校の劣等生
千葉寿和	魔法科高校の劣等生
桜井穂波	魔法科高校の劣等生
稲垣	魔法科高校の劣等生
千葉エリカ	魔法科高校の劣等生
中条あずさ	魔法科高校の劣等生
山中幸典	魔法科高校の劣等生
市原鈴音	魔法科高校の劣等生
真田繁留	魔法科高校の劣等生
安宿怜美	魔法科高校の劣等生
風間玄信	魔法科高校の劣等生
明智英美	魔法科高校の劣等生
十三束鋼	魔法科高校の劣等生
九島烈	魔法科高校の劣等生
七草真由美	魔法科高校の劣等生
ピクシー	魔法科高校の劣等生
十文字克人	魔法科高校の劣等生
渡久地	魔法科高校の劣等生
沢木碧	魔法科高校の劣等生
零乃まやか	魔法科高校の劣等生
一条将輝	魔法科高校の劣等生
善之助	魔法遣いに大切なこと
ミリンダ	魔法遣いに大切なこと
佐藤みちる	魔法遣いに大切なこと
アルシオーネ	魔法騎士レイアース
サンユン	魔法騎士レイアース
シエラ	魔法騎士レイアース
クレフ	魔法騎士レイアース
ランティス	魔法騎士レイアース
龍咲海	魔法騎士レイアース
イーグル・ビジョン	魔法騎士レイアース
ザズ・トルク	魔法騎士レイアース
鳳凰寺風	魔法騎士レイアース
モコナ	魔法騎士レイアース
イノーバ	魔法騎士レイアース
ラミントン	魔界戦記ディスガイア
ジェニファー	魔界戦記ディスガイア
魔王プリエ	魔界戦記ディスガイア
クリチェフスコイ	魔界戦記ディスガイア
マージョリー	魔界戦記ディスガイア
サーズデイ	魔界戦記ディスガイア
エトナ	魔界戦記ディスガイア
カーチス	魔界戦記ディスガイア
ブルカノ	魔界戦記ディスガイア
アイザック・モートン	魔界王子_devils_and_realist
サマエル	魔界王子_devils_and_realist
エリュゴス	魔界王子_devils_and_realist
レオナール	魔界王子_devils_and_realist
バアルベリト	魔界王子_devils_and_realist
マリア・モリンズ	魔界王子_devils_and_realist
ドロシー・マギー・ハウザー	魔術士オーフェン
オーフェン	魔術士オーフェン
ドーチン	魔術士オーフェン
ハーティア	魔術士オーフェン
ボニー・マギー	魔術士オーフェン
ルーファス	魔術士オーフェン
ボルカン	魔術士オーフェン
レキ	魔術士オーフェン
コギー	魔術士オーフェン
コンスタンス・マギー	魔術士オーフェン
アビー	魔豆奇伝パンダリアン
トビー	魔豆奇伝パンダリアン
新谷貞一	黄昏乙女×アムネジア
庚霧江	黄昏乙女×アムネジア
小此木ももえ	黄昏乙女×アムネジア
庚夕子	黄昏乙女×アムネジア
カーネル・サングロス	黄金勇者ゴルドラン
嵐山	黒塚_KUROZUKA
黒蜜	黒塚_KUROZUKA
トンバ	黒塚_KUROZUKA
石田英輝	黒子のバスケ
津川智紀	黒子のバスケ
白金耕造	黒子のバスケ
小堀浩志	黒子のバスケ
宮地清志	黒子のバスケ
鳴海大介	黒子のバスケ
岡村建一	黒子のバスケ
虹村修造	黒子のバスケ
河原浩一	黒子のバスケ
相田景虎	黒子のバスケ
荒木雅子	黒子のバスケ
古橋康次郎	黒子のバスケ
青峰大輝	黒子のバスケ
福田寛	黒子のバスケ
若松孝輔	黒子のバスケ
灰崎祥吾	黒子のバスケ
テツヤ2号	黒子のバスケ
根武谷永吉	黒子のバスケ
早川充洋	黒子のバスケ
葉山小太郎	黒子のバスケ
花宮真	黒子のバスケ
氷室辰也	黒子のバスケ
原一哉	黒子のバスケ
伊月俊	黒子のバスケ
紫原敦	黒子のバスケ
黒子テツヤ	黒子のバスケ
高尾和成	黒子のバスケ
大坪泰介	黒子のバスケ
笠松幸男	黒子のバスケ
遠山和樹	黒子のバスケ
井上智也	黒子のバスケ
水戸部凛之助	黒子のバスケ
松岡大吾	黒子のバスケ
パパ・ンバイ・シキ	黒子のバスケ
相田リコ	黒子のバスケ
望月和宏	黒子のバスケ
原澤克徳	黒子のバスケ
今吉翔一	黒子のバスケ
実渕玲央	黒子のバスケ
劉偉	黒子のバスケ
黄瀬涼太	黒子のバスケ
山崎弘	黒子のバスケ
白金永治	黒子のバスケ
木村信介	黒子のバスケ
火神大我	黒子のバスケ
谷村祐介	黒子のバスケ
瀬戸健太郎	黒子のバスケ
アレクサンドラ＝ガルシア	黒子のバスケ
春日隆平	黒子のバスケ
木吉鉄平	黒子のバスケ
岩村努	黒子のバスケ
降旗光樹	黒子のバスケ
桃井さつき	黒子のバスケ
荻原シゲヒロ	黒子のバスケ
緑間真太郎	黒子のバスケ
福井健介	黒子のバスケ
小金井慎二	黒子のバスケ
森山由孝	黒子のバスケ
日向順平	黒子のバスケ
諏佐佳典	黒子のバスケ
土田聡史	黒子のバスケ
マカナ	黒神_The_Animation
佐野茜	黒神_The_Animation
山崎優子	黒神_The_Animation
亜里沙	黒神_The_Animation
征司	黒神_The_Animation
北条水華魅	黒神_The_Animation
ナム	黒神_The_Animation
えみ	黒神_The_Animation
グスタフ	黒神_The_Animation
石崎	黒神_The_Animation
坪田	黒神_The_Animation
ロリポップ・ココア	黒魔女さんが通る!!
ギュービッド	黒魔女さんが通る!!
レオナール伯爵	黒魔女さんが通る!!
羅門ルル	黒魔女さんが通る!!
ギューバッド	黒魔女さんが通る!!
海音寺美珠亜	黒魔女さんが通る!!
悪魔情	黒魔女さんが通る!!
三条ショウ	黒魔女さんが通る!!
椴松鷲	龍ヶ嬢七々々の埋蔵金
唯我一心	龍ヶ嬢七々々の埋蔵金
星埜ダルク	龍ヶ嬢七々々の埋蔵金
真幌肆季	龍ヶ嬢七々々の埋蔵金
夢路百合香	龍ヶ嬢七々々の埋蔵金
不義雪姫	龍ヶ嬢七々々の埋蔵金
徒然影虎	龍ヶ嬢七々々の埋蔵金
壱級天災	龍ヶ嬢七々々の埋蔵金
茨夕	龍ヶ嬢七々々の埋蔵金
